who plays luke on star wars new hope	actor
show credits for the godfather	actor
who was the main actor in the exorcist	actor
find the female actress from the movie she 's the man	actor
who played dory on finding nemo	actor
who was the female lead in resident evil	actor
who played guido in life is beautiful	actor
who was the co-star in shoot to kill	actor
find the guy who plays charlie on charlie 's angels	actor
cast and crew of movie the campaign	actor
cast and crew of the campaign	actor
who plays in the movie the campaign	actor
who starred in the campaign	actor
who were the crew for the campaign	actor
who was the lead man in taxi driver	actor
star of twilight	actor
who stars in vulgaria	actor
what are the names of female actors who played in lost	actor
can i see the set list and cast for life is beautiful	actor
cast and crew of life is beautiful	actor
show cast and crew for the movie life is beautiful	actor
what 's the cast for life is beautiful	actor
who played in life is beautiful	actor
who played in life is beautiful	actor
who was in life is beautiful	actor
who were roberto benigni 's costars on life is beautiful	actor
i am looking for the actor that played in pretty women	actor
star of troy	actor
who played robin in batman forever	actor
find the male actor from dirty harry	actor
show me the actor of the ranam	actor
rocky actor	actor
what actor played in the amazing spider man	actor
who are the actors in captain america	actor
who starred in captain america	actor
who was in the movie captain america	actor
who were the cast members in the hobbist	actor
show me the actor of the movie varsham	actor
which female actors starred in hitch	actor
can i see the cast and crew for the movie in july	actor
list cast and crew in july	actor
who stars in in july	actor
who stars in in july	actor
roll credits for top gun	actor
show me the actor of the movie sirisiri muvva	actor
rocky 2 actor	actor
who is chewbakka	actor
who stared in i love lucy	actor
apollo thirteen cast members	actor
can you tell me more about the cast and crew of the movie apollo thirteen	actor
cast and crew for apollo thirteen	actor
castmembers of apollo thirteen	actor
complete cast and crew of apollo thirteen	actor
find for information about the cast of appolo thirteen	actor
find info on the crew of apollo thirteen	actor
give me more facts about the cast and crew of the movie apollo thirteen	actor
i need to know in detail about the cast and crew of the movie apollo thirteen	actor
i want to find information about the cast of apollo thirteen	actor
show me more information about the cast and crew of the movie apollo thirteen	actor
what actors were in dirty dancing	actor
show me the actors in captain america	actor
show me gilda 's credits	actor
i can 't remember the lead guy in the avengers	actor
show cast list for the avergers	actor
who plays nemo in finding nemo	actor
find cast and crew for the movie finding nemo	actor
show me the cast and crew for finding nemo	actor
show me the cast of finding nemo	actor
who are the main voices in finding nemo	actor
who starred in finding nemo	actor
who stars in finding nemo	actor
who was the main character in men in black 3	actor
can i see the credits for dirty dancing	actor
cast of dirty dancing	actor
find cast and crew for dirty dancing	actor
search cast and crew for dirty dancing	actor
search for the cast and crew for the movie dirty dancing	actor
show me the cast and list for dirty dancing	actor
who starred in dirty dancing	actor
who starred in dirty dancing	actor
who were the stars of dirty dancing	actor
who was the male star of titanic	actor
who starred in taxi	actor
who played in the oranges	actor
actors for life is beautiful	actor
who are the lead actors in life is beautiful	actor
find the male actor from the movie born free	actor
actor from iron man	actor
shows actors in shoot to kill	actor
which actors starred in hitch	actor
who are all of the actors in hitch	actor
who was the lead actor in hitch	actor
who starred in dark knight rising	actor
who played nick fury in the avengers	actor
who was the lead actor in the avengers	actor
what was the cast of black swan	actor
who acted in black swan	actor
who was in black swan	actor
who was the lead in black swan	actor
actors in star wars four	actor
what was the actor who played esme in twilight	actor
who played esme in twilight	actor
who starred in the parent trap	actor
cast and crew for hitch	actor
cast and crew of hitch	actor
cast hitch	actor
hitch crew	actor
list cast hitch	actor
show me hitch 's cast	actor
show the cast of hitch	actor
what actors appeared in the movie hitch	actor
what actors played in the movies hitch	actor
what was the cast of hitch	actor
who starred in hitch	actor
who starred in the movie hitch	actor
who stars in hitch	actor
who was in hitch	actor
who was in the movie hitch	actor
who was the star in hitch	actor
voice actor for homer simpson	actor
who is in the movie two can play that game	actor
actress from gone with the wind	actor
who are the lead actors in this movie	actor
show me information on the cast and crew of pitchperfect	actor
actors in house at the end of the street	actor
can i see the cast and crew for house at the end of the street	actor
cast and crew for house at the end of the street	actor
cast and crew for the movie house at the end of the street	actor
who stars on the house at the end of the street	actor
who is in movie	actor
who is in movie	actor
who is in movie	actor
who acts in forager	actor
who stars in forager	actor
who is the cast and crew for now forager	actor
who was in now	actor
actor from modern family	actor
list the actors in forager	actor
cast and crew of go	actor
who starred in go	actor
who was the lead actress in the hunger games	actor
show cast of movie request	actor
what is the cast in resident evil retribution	actor
list me the actors for top gun	actor
who was the tin man in wizard of oz	actor
actress in hum tum	actor
who was the actor in movie hum tum	actor
who is in barfi	actor
who was the lead woman in the savages	actor
find the name of the actor who played jack in the movie titanic	actor_name
the name of the male lead in the movie titanic	actor_name
what is the name of the lead actor in the titanic	actor_name
show me who played what role in go	actor_name character
i cannot remember the name of the actor in pretty women	actor_name
what is the name of the actor who was in the parent trap	actor_name
find name of main actor in the movie the help	actor_name
looking for names of crew members of apollo thirteen	actor_name
i can 't figure out the name of the lead guy in the avengers	actor_name
what were the names of the ladies in facts of life	actor_name
how old is steven spielberg	birth_date
when steven spielberg born	birth_date
what is tom cruise 's birthday	birth_date
when was tom cruise born	birth_date
when is will ferrell 's birthday	birth_date
how old is kristen stewart	birth_date
how much did it cost to produce the dark night	budget
how much did the dark night cost to produce	budget
what was the dark night budget	budget
the godfather 's budget	budget
budget for the blind side	budget
i want to look up the budget of freedom writers	budget
i would like to look up the budget of freedom writers	budget
look for the budget of freedom writers	budget
how much was hunger games made for	budget
how much was the budget for the hunger games	budget
how much did black swan cost	budget
how much did hollywood pay for black swan	budget
what was the budget for black swan	budget
what were production costs for black swan	budget
what was the budget for wrong turn	budget
search for the budget of step up	budget
budget for titanic	budget
budget for titanic	budget
budget for titanic movie	budget
how much did titanic cost to make	budget
how much was the total budget for the titanic	budget
what was titanic 's budget	budget
what was the budget for courageous	budget
what was the budget for facing the giants	budget
budget of heroine	budget
finding the buget of heroine	budget
looking of movie heroine 's budget	budget
what is the buget of movie heroine	budget
how much did it cost to make jurassic park	budget
what was the budget for jurassic park	budget
how much did james cameron have to spend to make avatar	budget
avatar must have cost a bundle	budget
did the avatar movie have a budget for spending	budget
get me info on the budget for avatar	budget
how much did it cost to make avatar	budget
how much did the studio spend to make avatar	budget
how much money was budgeted for the avatar movie	budget
i need to know the budget of the movie avatar	budget
i want to know the avatar 's budget	budget
list the budget for avatar	budget
show me what was the budget of the movie avatar	budget
what did the movie avatar cost to make	budget
what was avatar 's budget	budget
what was the budget for avatar	budget
what was the budget for avatar	budget
what was the budget for avatar	budget
what was the budget for the movie avatar	budget
what was the budget of the movie avatar	budget
how much did the movie avatar cost	budget
how much money was spent on batman	budget
tell me the budget for the movie batman	budget
how much did batman begins cost	budget
how much was it to make the film batman begins	budget
budget for the avengers	budget
how much did it take to make the avengers	budget
what was the budget for the avengers	budget
what was the budget for citizen kane	budget
find out the budget of cujo	budget
budget for gone with the wind	budget
gone with the wind 's budget information please	budget
gone with the wind 's budget	budget
show me the budget for the movie	budget
budget for the hulk	budget
budget request for my big fat greek wedding	budget
find the budget of my big fat greek wedding	budget
how much did my big fat greek wedding cost	budget
what was the budget of my big fat greek wedding	budget
what was the budget for old school	budget
what was the bourne identity 's budget	budget
how much did it cost to produce the deer hunter	budget
provide the cost for producing the deer hunter	budget
will you show the cost to produce the deer hunter	budget
what was the budget for the hobbit	budget
can i see what the lion king 's budget was	budget
show me the lion king 's budget	budget
what was the budget for passion of the christ	budget
what was the budget for top gun	budget
what was top gun 's budget	budget
who does ellen degeneres play in finding nemo	character
what character did tom hanks play in apollo thirteen	character
lion king characters	character
what character did will smith play in hitch	character
what role did sarah polley play in go	character
what was kevin james role in hitch	character
who directed the music in gone with the wind	composer
show me the music composer for the movie	composer
who directed the musical score in barfi	composer
how many films did ed harris do with tom hanks	movie_count
how many movies were released on nine twenty eight twelve	movie_count
how many movies were filmed in asia	movie_count
how many films directed by barbra streisand have been shot in the czech republic	movie_count
how many movies has albert ruddy produced	movie_count
how many movies has lionsgate done	movie_count
how many movies did richard lester direct	movie_count
how many films has taye diggs been in	movie_count
how many movies has ray stark produced	movie_count
how many producers did the movie the hitch have	producer_count
how many movies has charles vidor directed	movie_count
how many movies has kristen stewart made	movie_count
i wonder how many movies alfred hitchcock was in that he directed	movie_count
how many movies has steven spielberg directed	movie_count
how many films did robert wise direct	movie_count
how many movies has tom cruise starred in	movie_count
how many movies did scorsese direct	movie_count
how many movies has angelina jolie been in	movie_count
how many movies did victor fleming direct	movie_count
how many movies has woody allen directed	movie_count
how many movies has darla anderson produced	movie_count
how many films did alfred hitchcock direct	movie_count
how many movies did hitchcock direct	movie_count
how many movies has tom hanks starred in	movie_count
how many woody allen movies starred diane keaton	movie_count
how many films has ed harris starred in	movie_count
how many movies are made in the united states	movie_count
where was footnote made	country
what country did the flowers of war come from	country
country of le havre	country
what country does the movie kati patang comes from	country
show me the name of the country for the movie thoda pyaar thoda magic	country
can you tell me which country the movie kati patang comes from	country
i need to know the name of the country to which the movie kati patang belongs to	country
show me the name of the country from which the movie kati patang comes	country
can you tell me which country does thoda pyaar thoda magic belongs to	country
give me the name of the country for the movie thoda pyaar thoda magic	country
i need to know which country does the movie thoda pyaar thoda magic belongs to	country
country that made a separation	country
what country is godzilla	country
country of weekend	country
i would like to search for what country cell 21 is from	country
look for what country cell 21 is from	country
what country is cell 21 from	country
what country did black beauty come from	country
i need to know where trainspotting comes from	country
tell me where is trainspotting from	country
which country made elizabeth	country
where was trainspotting made	country
what country did shindler 's list come from	country
which country is this movie from	country
show me where black swan is from	country
where was black swan produced	country
what is the origin of casa blanca	country
origin of gone with the wind	country
lion king filmed at	country
where was rocky four filmed	country
origin of spanglish	country
movie made where	country
what country is movie from	country
in what country was movie made	country
where was movie made	country
is this a foreign film	country
is this a foreign film	country
what country was kinky boots made in	country
what country is outside the law from	country
what country produced the movie mirror	country
what country does mirror come from	country
what country does les miserable come from	country
what is the origin country of mirror	country
in what country was the movie mirror produced	country
where was the movie mirror produced	country
when can i see top gun	release_date
when was top gun released	release_date
when does top gun come out	release_date
when the movie top gun was released	release_date
when did richard lester start directing	release_date
when was in july released	release_date
give me the release date for the little mermaid	release_date
what date was spider released	release_date
can you tell me when 24 will be released	release_date
do you know when 24 will be released	release_date
i want to know when 24 will be released	release_date
when will 24 be released	release_date
how will i know when the movie gone with the wind will be released	release_date
please tell me when was the movie gone with the wind released	release_date
please tell me when will the movie gone with the wind will be released	release_date
when will the movie gone with the wind be released	release_date
do you know when this movie is available	release_date
what year was the movie released	release_date
which decade did the movie come out	release_date
which month was the movie released	release_date
release day for the movie	release_date
may i have the date of release for this movie	release_date
release date for the vow	release_date
when was black beauty released	release_date
titanic release date	release_date
when did lionsgate start making movies	release_date
search when the birds will be released	release_date
what year did spielberg start directing movies	release_date
the godfather came out when	release_date
when can i see the great gatsby	release_date
when will the great gatsby be out	release_date
when will the great gatsby be released	release_date
when will jaws be released	release_date
when will the hobbit be released	release_date
what year was the hobbit relased	release_date
what year did the movie grease open	release_date
movie little women release date is when	release_date
release date for little women	release_date
when was the movie title little women released	release_date
can you please tell me when was karate kid released	release_date
karate kid release date	release_date
find release date for karate kid	release_date
when did dirty dancing come out	release_date
when was dirty dancing released	release_date
what year was dirty dancing released	release_date
when was dirty dancing released	release_date
when was overboard released	release_date
what year did moon over parador come out	release_date
release date for batman	release_date
when did jurassic park get released	release_date
lion king release yr	release_date
when was while you were sleeping released	release_date
what year was ed harris in in apollo thirteen	release_date
what was the date when welcome to the dollhouse was released	release_date
release date for toy story	release_date
what was the relase date for men in black	release_date
when was life is beautiful released	release_date
when was life is beautiful released	release_date
when life is beautiful was released	release_date
what is possessed realese date	release_date
look up the release date of resident evil	release_date
what is resident evil 's release date	release_date
when did resident evil come out	release_date
when did resident evil debut in theaters	release_date
when did theaters show resident evil	release_date
when was the release date for the movie resident evil	release_date
when was resident evil first in theatres	release_date
when was the scooby do movie released	release_date
when was finding nemo released	release_date
release date for finding nemo	release_date
when was finding nemo released	release_date
when was finding nemo released	release_date
in which date varsham movie released	release_date
in which month varsham movie released	release_date
release twilight	release_date
frankenstein release	release_date
frankenstein release date	release_date
when will the movie frankenstein be released	release_date
when was hum tum relesed	release_date
i want to know when step up was released	release_date
i would like to know when the movie step up was released	release_date
when was step up released	release_date
when was the movie step up released	release_date
when did happiness get released	release_date
when will paranormal activity be released	release_date
avatar realease date	release_date
avatar release	release_date
what was the release date for avatar	release_date
when did the movie avatar get released	release_date
when avatar released	release_date
when was avatar released	release_date
i need to know when was the movie avatar released	release_date
what day avatar released	release_date
what was the release date of the movie avatar	release_date
when was avatar released	release_date
what date was avatar released	release_date
when was black swan in the theatre	release_date
when was black swan released	release_date
how long has black swan been out	release_date
find release date of the help	release_date
when can the help be released	release_date
tell me when compliance came out	release_date
when is sinister hitting theaters	release_date
release date for the hunger games	release_date
when was the first hunger games shown	release_date
when was avengers released	release_date
when was lawless released	release_date
release date of snow white and the huntsman	release_date
release date for amazing spiderman	release_date
when will the next amazing spiderman come out	release_date
when was the amazing spiderman released in the movie theatres	release_date
search for the release date of vulgaria	release_date
when did vulgaria come out	release_date
when was the movie vulgaria released	release_date
what date did vulgaria open	release_date
when did dredd come out	release_date
what year was the godfather released	release_date
release date for the watch	release_date
when was paranorman be released	release_date
what year was the campaign released	release_date
when was the campaign released	release_date
when was expendables 2 released	release_date
when is the release date of resident evil : retribution	release_date
what is the calendar date release for looper	release_date
i would like to know the release date of the movie barfi	release_date
i need to know the release date of the movie barfi	release_date
what is the release date of the movie barfi	release_date
show me the release date of the movie barfi	release_date
find the release date for heroine	release_date
please find the release date of heroine	release_date
what is the release date of heroine	release_date
when was herione released	release_date
when was the movie heroine released	release_date
when was house at the end of the street released	release_date
when house at the end of the street showing	release_date
what is the release date for house at the end of the street	release_date
is iron man 3 in theatres yet	release_date
when is iron man 3 coming out	release_date
when will iron man 3 be out in movie theatres	release_date
show me movies listed by directors	director movie_name
director for gone with the wind	director
show me the directors of gone with the wind	director
who are the directors of gone with the wind	director
who directed gone with the wind	director
who directed gone with the wind	director
who directed gone with the wind	director
who directed the movie	director
show me details about the directors of gone with the wind	director
who directed black swan	director
who 's the director of pi	director
who made batman the dark knight	director
tell me about inception 's director	director
show me the director of the film the dark knight	director
tell me the director of the film the dark knight	director
who directed the movie the dark knight	director
who filmed the dark knight	director
who is the person that directed the film the dark knight	director
which director directed a hard day 's night	director
who directed a hard day 's night	director
who directed a hard day 's night	director
who directed hard days night	director
who directed cast away	director
show me the director of forest gump	director
who was the director of forest gump	director
who is director of sleepless in seattle	director
who directed the movie opening night	director
who directed the movie men in black 3	director
who was the director in men in black 3	director
can you tell me the director of the titanic	director
director for titanic	director
who was the director of the movie titanic	director
display director of the movie avengers	director
director of the avengers	director
search director of the exorcist	director
find the director for the social network	director
find the director of big	director
who is the director of ghost busters	director
find the director for pretty woman	director
who made godzilla	director producer
rocky director	director
who directed hope floats	director
avatar was directed by whom	director
director of avatar	director
which director directed avatar	director
who did avatar	director
who directed avatar	director
who directed avatar	director
who directed avatar	director
who directed the film avatar	director
who directed the movie called avatar	director
who made the movie avatar	director
who was the director of the movie avatar	director
who directed star wars four	director
who directed the movie in july	director
who made steel magnolias	director
the silence of the lambs director	director
director of the incredibles	director
gilda director	director
list gilda director	director
search director for gilda	director
search gilda director	director
the movie gilda director	director
who directed gilda	director
who directed gilda	director
who directed gilda	director
who directed the movie gilda	director
goodfellas director	director
who made field of dreams	director
who made the movie field of dreams	director
who made the movie field of dreams possible	director
can i please see more details for the director of finding nemo	director
find the director for finding nemo	director
i want to know the director of finding nemo	director
i want to know who directed finding nemo	director
show me finding nemo director	director
who directed finding nemo	director
who directed finding nemo	director
who directed finding nemo	director
who directed finding nemo	director
who directed finding nemo	director
who directed finding nemo	director
who was the director of the film finding nemo	director
who directed hitch	director
who made hitch	director
director for anne of green gables	director
search director of the movie platoon	director
who was the director of movie varsham	director
who directed grizzly man	director
who directed to kill a mockingbird	director
who was the director of the movie e t	director
find the director for et	director
who made et	director
who was the director of the movie jaws	director
look up info about jurassic park 's director	director
who directed jurassic park	director
who directed jurassic park	director
who directed jurassic park	director
old man director	director
can you find out who directed the movie batman	director
can you tell me who is the director of batman	director
who directed batman	director
who is the director of batman	director
looper directors	director
who directed the perfect storm	director
who directed dirty dancing	director
director for pride and prejudice	director
who directed the movie the thing called love	director
director of twilight	director
twilight was directed by whom	director
who else directs zombie movies	director
director of hum tum	director
director of the movie hum tum	director
find the director of hum tum	director
look for the director of hum tum	director
director of the cabin in the woods	director
i am interested in who directed cabin in the woods	director
show me who directed cabin in the woods	director
who directed the movie cabin in the woods	director
who directed soul surfer	director
who directed the sandlot	director
which director made a comedy	director
director of halloween	director
find the director of step up	director
search for the director of step up	director
search for the director of step up	director
i need to know who directed black swan	director
i want to look for the director of freedom writers	director
i would like to look for the director of freedom writers	director
who directed the movie titanic	director
who was the director of the movie the mechanic	director
find the director of mask	director
director of the hulk	director
did robert wise direct the sound of music	director
was robert wise the only director of the sound of music	director
who directed the sound of music	director
who directed the sound of music	director
who directed the sound of music	director
what director shot the 1st lord of the rings film	director
who directed return	director
who is the director of return	director
search for the name of the director of return	director_name
what was the name of the director in men in black 3	director_name
what is the name of the director of the movie avengers	director_name
find the name of the director of chips	director_name
name of director for house at the end of the street	director_name
name the director of sleepless in seattle	director_name
find name of director of the movie platoon	director_name
get me the name of who directed the master	director_name
what is the director 's name of lord of the rings	director_name
what is the name of the person who made et	director_name
rocky director 's name	director_name
what type of movie is gilda	genre
what types of movies does lionsgate produce	genre
what kind of movie is black swan	genre
what genre is the hunger games	genre
genre for transformers	genre
what genre is looper	genre
what genre is the movie looper	genre
what genre is rambo	genre
what genre is the jaws movies	genre
can you tell me the genre for 1000 words	genre
i am interested in the genre for 1000 words	genre
what type of movie is parenthood	genre
give me the genre of the movie lawless	genre
what genre is the movie lawless	genre
what is the genre of the movie lawless	genre
what genre is the movie in july	genre
genre for gone with the wind	genre
how is the movie classified	genre
what genre is the movie	genre
what is the movie category	genre
how would you describe the movie	genre
type of movie	genre
what is the classification of movie	genre
what is the genre for movie	genre
what is the movie genre	genre
what kind of movie	genre
what type of movie is this	genre
i would like look up the genre step up is in	genre
search for the genre step up in	genre
what genre is step up in	genre
what genre is calendar girls in	genre
what is the genre for the patriot	genre
what genre is network in	genre
find out the genre for the movie rebel	genre
genre for the avengers	genre
can you tell me what genre the movie avatar falls in	genre
i need to know the genre of the movie avatar	genre
show me the genre of the movie avatar	genre
what genre is superman	genre
pretty girl movie genre	genre
pretty girl what is the movie 's genre	genre
what genre is pretty girl	genre
what genre is the movie pretty girl	genre
find out what kind of movie grease is	genre
i d like to know the genre of the film grease	genre
i would like to know the genre of grease	genre
what kind of movie is grease	genre
find out the genre for the movie annamayya	genre
what movie category is friday the 13th	genre
tell me what genre the tommyknockers is	genre
what genre is the hangover	genre
what catergory is ted in	genre
what genre is ted considered	genre
what type of movie is ted considered to be	genre
genre for while you were sleeping	genre
what genre is finding nemo	genre
which language is used in the movie	language
language of sound of music	language
what language is this film	language
what are the different languages this movie come in	language
what foreign language is spoken in movie	language
what language is movie in	language
what language is the movie in	language
what language is the movie in	language
language of anna karinia	language
language of godzilla movie	language
language of hamlet	language
can you tell me the language of the movie hero	language
i need to know what is the language of the movie hero	language
tell me what is the language of the movie hero	language
language of bullhead	language
what language is shindler 's list in	language
what language did the characters speak in black swan	language
what language is black swan	language
please find what language the chaser is in	language
what language is the chaser in	language
look up what language the chaser is in	language
ondskan 's language	language
what language is la havre in	language
what foreign language is the movie belle available to view in	language
what language can i watch the movie the professional	language
what language is the professional in	language
how do they speak in the movie the professional	language
what language is spoken in indochine	language
language of the film revanche	language
what language was aguirre wrath of god in	language
what language is passion of the christ in	language
i want to know in what language was ju on filmed	language
i want to know the original language of ju on	language
tell me the language of ju on	language
what language is ju on on	language
what language is the movie elling in	language
language of a separation	language
what s the language of moscow does not believe in tears	language
what is the language of the movie aankhen	language
can you tell me the language of the movie aankhen	language
what are the names of films produced by steven spielberg	movie_name
can you tell me names of some movies by director martin scorsese	movie_name
find movie titles	movie_name
what are the names of movies made in the united states	movie_name
i would like to know the names of all the movies which have been directed by james cameron	movie_name
what are the titles of all the movies that george lucas produced	movie_name
names of romantic indian films	movie_name
can you show me names of some indian romantic movies	movie_name
i would like to know names of some indian movies	movie_name
japanese movie titles	movie_name
can you give me names of some movies having pg thirteen rating	movie_name
i would like to get names of some movies with pg thirteen rating	movie_name
show me names of some romantic movies having a pg thirteen rating	movie_name
what are the names of movies with zombies in them	movie_name
i need to know the names of all the movies produced by william packer	movie_name
stephen king directed what movie	movie
what movies did stephen king direct	movie
watch the last james cameron movie	movie
find movies by release date	movie date
show movie ratings	movie rating
movie ratings	movie rating
richard lester produced what other movies	movie
show me westerns	movie
was kevin bacon in apollo thirteen	movie
i need movie information for life is beautiful	movie
life is beautiful movie page	movie
i want to know more about the movie life is beautiful	movie
i would like info on the movie life is beautiful	movie
please show me info on the movie life is beautiful	movie
search for the movie life is beautiful	movie
what are the particulars for the movie life is beautiful	movie
can i see more info the movie life is beautiful	movie
can you show me info on the movie life is beautiful please	movie
display information for the movie life is beautiful	movie
find movies about dancing	movie
i want to look up movies about dancing	movie
look up movies about dancing	movie
search for movies about dancing	movie
give me a list of will ferrell films	movie
i want to see any movies will ferrell has been in	movie
i would like to see will ferrell movies	movie
list will ferrell films	movie
movies will ferrell played in	movie
what are some films will ferrell starred in	movie
what movies has will ferrell been in	movie
what movies is will ferrell in	movie
will ferrell films	movie
will ferrell movies	movie
will ferrell movies	movie
will ferell videos	movie
i want to see videos of will ferrell	movie
all videos of will ferrell	movie
can you find me movies in russian	movie
where can i find movies in russian	movie
find russian movies	movie
find russian movies	movie
search for russian movies	movie
show me movies from poland	movie
i would like to see a polish language film	movie
i am interested in watching a movie in polish	movie
i want to see a polish movie	movie
list some funny russian movies	movie
i am looking for the information on the movie pretty women	movie
list of barry sonnenfeld films	movie
find martin scorsese films	movie
i want to see a movie which was directed by scorsese	movie
show all movies directed by martin scorcese	movie
movies with meg ryan	movie
gross earnings for movies	movie revenue
i want to watch movies directed by jackie chan	movie
star wars	movie
what are the plots of hotel rwanda	movie
tim burton movies	movie
bings movie page finding nemo	movie
display information for film finding nemo	movie
finding nemo movie shortcut	movie
whats some details for the movie finding nemo	movie
show all details of original finding nemo movie	movie
get details of original finding nemo movie	movie
finding nemo movie page	movie
find movie finding nemo	movie
display all details of original finding nemo movie	movie
find all details of original finding nemo movie	movie
what has andrew stanton directed	movie
what movies has andrew stanton directed	movie
what did lee unkrich direct	movie
i would like to see a movie with albert brooks in it	movie
find me films produced by drew barrymore	movie
what movies that clint eastwood starred in did he also direct	movie
what movies did clint eastwood direct and star in	movie
i want to watch a movie by sergio leone	movie
show sergio leone 's movies	movie
show me movies directed by sergio leone	movie
movies that have been directed by tony scott	movie
show me movies from brazil	movie
show me horror movie earnings	movie revenue
movies with harrison ford	movie
show me only movies with harrison ford	movie
name the movies clive owen has been in	movie
what movies has clive owen been in	movie
what movies has clive owen starred in	movie
find ms. congeniality	movie
find spike lee directed movies	movie
what movies did spike lee direct	movie
movies cecil b demille	movie
i want to see a comedy in spanish	movie
find films	movie
find films	movie
find movies	movie
in search for movies	movie
looking for movies	movie
find a movie	movie
are there movies not rated g	movie
i don 't want any g rated movies	movie
can you find some drama movies	movie
i 'd like to watch something with drama	movie
looking for a drama movie	movie
show me a list of movies in english	movie
show me english movies	movie
find english movies	movie
can i get a list of movies available in english	movie
show me movies in english	movie
i would like to see movies in english	movie
movies in english	movie
show me a list of all movies made in the united states	movie
what are all movies made by united states	movie
what movies have been made in the united states	movie
movies from the us	movie
what are all of the movies made in usa	movie
i want to see movies made in america	movie
show me a list of movies made in america	movie
show me movies made in america	movie
please tell me if you have any movies from the united states	movie
movies from the us	movie
please tell me about movies from the usa	movie
english movie list	movie
show me thrillers	movie
show me thrillers	movie
show me comedies	movie
looking for a comedy movie	movie
see comedy	movie
show me comedy movies	movie
show me funny movies	movie
movies that have comedy	movie
can you show me a list of scary movies	movie
i am in the mood for a horror film	movie
looking for a horror movie	movie
search for horror movies	movie
show me horror movies	movie
show only horror movies	movie
show me a list of scary movies	movie
i want to see a list of scary movies	movie
funny scary movies	movie
movies by producer	movie producer
find movies by producer	movie producer
movies with bruce willis	movie
clint eastwood movies	movie
find movies from canada	movie
get me canadian movies	movie
show me movies from canada	movie
look up information about canadian movies	movie
get movies from canada	movie
show me a list of any movies made in canada	movie
find movies filmed in canada	movie
get films made in canada	movie
show me canadian films	movie
show me canadian movies	movie
are there any canadian movies	movie
are there any canadian movies	movie
find canadian films	movie
what are some movies made outside the us	movie
movies from germany	movie
i want to watch movies from germany	movie
display movies made in germany	movie
find movies done in germany	movie
what movies do you have that were made in italy	movie
movies from italy	movie
does italy make any movies	movie
find italian movies	movie
italian films	movie
italian movies	movie
show me italian movies	movie
get all italian language movies	movie
send me movies that are in italian	movie
movies with italian language	movie
show me movies in italian	movie
what movies are in italian	movie
search for movies in italian	movie
find movies in italian	movie
a list of all italian speaking movies	movie
give me a list of movies from spain	movie
see movies from spain	movie
movies from spain	movie
movies from spain	movie
i want to see movies from spain	movie
movies made in spain	movie
are there any movies made in spain	movie
bring up spanish movies	movie
can you show me movies spanish	movie
can you show me spanish movies	movie
find spanish movies	movie
find spanish movies	movie
get me spanish movies	movie
I 'd like a list of spanish movies	movie
I 'd like to know some spanish movies	movie
i want only spanish movies	movie
i want to look up spanish movies	movie
list spanish movies	movie
list spanish movies	movie
look for spanish movies	movie
search for spanish movies	movie
search for spanish movies	movie
show me spanish movies	movie
spanish movie listing	movie
spanish movies	movie
find romance movies	movie
give me a list of romance movies	movie
find me romantic movies	movie
i want to find romantic movies	movie
locate romantic movies for me	movie
list some movies that are in french	movie
find french language movies	movie
find movies in french	movie
find movies is french	movie
list movies in french	movie
look for movies in french	movie
search for movies in french	movie
search for movies in french	movie
show me movies produced in french	movie
show movies in french	movie
show only movies that are in french	movie
find french language movies	movie
list of all french speaking films	movie
list of french language movies	movie
show me movies in french	movie
can you list movies in french	movie
find all films showing in french	movie
show me a list of all the movies produced by william packer	movie
information about movie	movie
show me information about movie	movie
show me information on movie	movie
tell me about movie	movie
please show me all of the films that involve kevin bacon	movie
i want movies about 9-11	movie
what other movies has bill paxton starred in	movie
find some suspenseful movies	movie
a movie based on time travel	movie
find time travel movies	movie
give me a list of time travel movies	movie
movies about time travel	movie
show me movies about time travel	movie
show me movies with time travel themes	movie
show me time travel movies	movie
show videos about time travel	movie
time travel movies	movie
what are movies whose topic involves time travel	movie
movies about time travel	movie
movies about time travel	movie
show me movies about time travel	movie
show me movies about time travel	movie
show me some movies that are related to time travel	movie
what are some movies that involve time travel	movie
what movies discuss time travel	movie
quentin tarrantino movies	movie
what movies did quentin terrantino direct	movie
list the movies anna paquin has starred in	movie
movies from england	movie
movies from england	movie
movies from england please	movie
show me england movies	movie
show me movies from england	movie
show me movies made in england	movie
find movies directed by chris columbus	movie
what other movies has richard lester directed	movie
search for movies by language	movie language
mandarin movie please	movie
please find a movie in mandarin	movie
movie made in mandarin	movie
which movies are originally in a foreign language	movie
find me tamil movies	movie
show me the latest movies in tamil	movie
find hindi movies	movie
find movies in hindi	movie
list the hindi movies	movie
what is hindi	movie
i would like to get a list of movie names in hindi language	movie
what films are not spoken in english	movie
what movies are spoken in another language	movie
i want to watch a romance made in india	movie
i need to get a list of some romantic indian movies	movie
find movies from india	movie
look up movies from india	movie
see movies from india	movie
find indian movies	movie
give me a list of some indian movies	movie
brian de palma movies	movie
complete list of movies made by searchlight films	movie
list movies by searchlight films	movie
list of movies produced by searchlight films	movie
what are some movies made by searchlight films	movie
movies about bank robberies	movie
show me sarah polley movies	movie
show me french r rated dramas	movie
list french language comedy films	movie
show french comedy films	movie
what are some movies that were produced in europe	movie
films produced by laurie macdonald	movie
find me dreamworks films	movie
movie by dreamworks	movie
movie made by dreamworks	movie
what movies are made by dreamworks	movie
i 'm looking for the cost of some movies	movie budget
what movies did kevin costner direct	movie
dirty dancing movie	movie
dirty dancing movie short cuts	movie
show me the dirty dancing movie	movie
will you please show me info on the movie dirty dancing	movie
find the movie dirty dancing	movie
get me info for the movie dirty dancing	movie
i need to get every possible information related with the movie dirty dancing	movie
i want to see infomation on the movie dirty dancing	movie
i would like to get all the information about the movie dirty dancing	movie
please show me info on the movie dirty dancing	movie
show me all the information about the movie dirty dancing like story reviews cast etc	movie
show me info on the movie dirty dancing please	movie
show me information for the movie dirty dancing	movie
show me more details for the movie dirty dancing	movie
can you please show me info on the movie dirty dancing	movie
can you tell me about the movie dirty dancing in detail	movie
what films has robert redford directed	movie
i want to see a robert redford produced movie	movie
i would like to see something produced by robert redford	movie
bette midler movies	movie
bette midler movies please	movie
show bette midler movies	movie
show me cameron diaz movies	movie
show me movies with jennifer aniston	movie
russell crowe movies	movie
about life is beautiful	movie
details about life is beautiful please	movie
find synopsis for life is beautiful	movie
i need page on life is beautiful	movie
i want information about life is beautiful	movie
i want to know about life is beautiful	movie
i would like to view info on life is beautiful	movie
life is beautiful	movie
run a search for life is beautiful	movie
show me life is beautiful information	movie
what 's the synopsis of life is beatiful	movie
footloose	movie
show jason statham movies	movie
list statham 's movies	movie
find movies from new zealand	movie
show me the movies acted by bala krishna	movie
korean language movie	movie
show me korean language movie	movie
can you find the movies with korean language	movie
show me movies that are in korean	movie
portugese movies	movie
current movie options for today with patrick swayze	movie
display all results for dirty dancing	movie
find information on dirty dancing	movie
search for dirty dancing	movie
search for dirty dancing	movie
how can i view dirty dancing	movie
dirty dancing facts	movie
did alfred hitchcock direct a comedy	movie
martin lawrence directed what movie	movie
find movies from japan	movie
show me movies from japan	movie
show me movies from japan	movie
what are some movies made in japan	movie
what movies came from japan	movie
which movies were made in japan	movie
i want to find a list of movies made in japan	movie
do you have any movies made in japan	movie
find japanese movies	movie
find japanese movies	movie
give me some names of japanese movies	movie
i want japanese movies	movie
i want to see japanese movies	movie
i would like to know names of some of the japanese movies	movie
japanese movies	movie
show me a list of some japanese movies	movie
show me japanese movies	movie
sort in all japanese movies	movie
do you have a list of japanese movies	movie
i want to see a film in japanese	movie
show me movies in japanese	movie
films with japaneese	movie
what movies have people speaking japanese in them	movie
what are some japanese movies	movie
find movies in british english	movie
find movies from miramax	movie
see miramax movies	movie
watch miramax	movie
find movies with sandra bullock	movie
find sandra bullock movies	movie
movies with sandra bullock	movie
movies with vampires	movie
what movies about vampires are there	movie
movies will smith stars in	movie
show me will smith movies	movie
what experience does darla anderson have as a producer	movie
look for movies directed by tyler perry	movie
which movies are directed by tyler perry	movie
give me movies directed by tyler perry	movie
search for movies directed by tyler perry	movie
what films has selena gomez been in	movie
find a movie with mel gibson	movie
only mel gibson movies	movie
find movies produced by paramount pictures	movie
i want to see paramount movies	movie
i would like a list of paramount movies	movie
list some paramount produced films	movie
show all movies by paramount	movie
show me all the movies made by paramount	movie
show only paramount movies	movie
is there a list of movies about chess	movie
movies about chess	movie
movies regarding the hobby of chess	movie
list some of the best world war 2 films	movie
find movies about dogs	movie
find movies with a nc 17 only	movie
find me nc-17 movies	movie
show me nc seventeen movies	movie
play movies from turkey	movie
what movies have come out of turkey	movie
can i have a list of bruce lee produced movies	movie
can you give me a list of movies produced by bruce lee	movie
show me movies produced by bruce lee	movie
i want to see movies directed by michael bay	movie
what movies did michael bay direct	movie
ed harris films	movie
show me all movies that star ed harris	movie
more stuff about the movie go	movie
is parenthood a comedy	movie
find movies produced by mel gibson	movie
what movies has jerry bruckheimer produced	movie
i want to see chinese movies	movie
show me chinese movies	movie
show me dramas from china	movie
i want to watch a drama made in china	movie
give me the best baseball movies	movie
list movies filmed in ireland	movie
list all the movies john travolta has done	movie
columbia production company movies	movie
find me 20 th century fox films	movie
list of 20 th century fox films	movie
watch century fox movies	movie
films produced by twentieth century fox	movie
find movies by twentieth century fox	movie
find twentieth century fox movies	movie
search twentieth century fox	movie
show me movies by twentieth century fox	movie
show me elvis movies	movie
do you have any pg thirteen rated movies	movie
show me pg thirteen movies	movie
what movies are rated pg thirteen	movie
find pg thirteen movies	movie
show me movies that are rated pg thirteen	movie
list all movies rated pg-13	movie
find movies with pg-13 only	movie
i need to know names of some movies which have a rating of pg-13	movie
i want to find pg-13 rated movies	movie
pg-13 movies	movie
which movies are rated pg-13	movie
find a pg-13 movie	movie
find me pg-13 movies	movie
find movies that are rated pg-13	movie
give me a list of some movies that have pg-13 rating	movie
i want to see a list of g rated movies	movie
list g	movie
what is a list of g movies	movie
are there any g movies out there right now	movie
find me movies rated g	movie
find movies only g	movie
get me only g-rated movies	movie
i want a list of movies rated g	movie
i want to see g-rated films now	movie
i want to take my kids to a g movie	movie
list of g movies	movie
list rating g	movie
listing of g movies	movie
look for movies rated g	movie
look up movies with a g rating	movie
play list g	movie
please select the option to search for g rated movies	movie
rating g	movie
search for movies rated g	movie
show me g rated movies	movie
show only g rated movies	movie
what available movies are rated g	movie
what movies are currently playing that are rated g	movie
find me movies rated g	movie
find movies that are rated g	movie
find movies with g rating	movie
g movies	movie
it is hard to find a movie that is rated g anymore	movie
list movies rated g	movie
only movies rated g	movie
rating g list	movie
show me g movies	movie
there are several g movies	movie
appropriate for kids	movie
what movies can young children watch	movie
watch pg and g movies	movie
did robert wise direct any other musical films	movie
find love stories	movie
find love stories	movie
show me a list of movies produced by mgm	movie
movies from the uk	movie
show me british films	movie
list uk movies	movie
get films from the united kingdom	movie
i want to watch a comedy made in norway	movie
get me a list of movies that ron howard produce	movie
ron howard movies produce list	movie
list movies directed by clint eastwood	movie
show director clint eastwood movies	movie
what movies did clint eastwood direct	movie
movies directed by clint eastwood	movie
list movies produced by sean penn	movie
find movies about vietnam	movie
what movies has spielberg been a producer on	movie
i would like to select the option to search for movies produced by stephen spielberg	movie
please list all movies that stephen spielberg produced	movie
select the option to search for movies produced by stephen spielberg	movie
which productions are from stephen spilberg	movie
find movies produced by steven spielberg	movie
list steven spielberg produced movies	movie
show me movies produced by stephen spielberg	movie
was kevin james in hitch	movie
was will smith in hitch	movie
show me a list of disney movies	movie
give me a list of some movies by producer walt disney	movie
list all movies that walt disney produced	movie
show all movies directed by ron howard	movie
what movies has ron howard directed	movie
find movies by ron howard	movie
show movies directed by ron howard	movie
find movies produced by brian glazer	movie
list spielberg movies	movie
show spielberg movies	movie
what did spielberg direct	movie
stephen spielberg movies	movie
filmography for steven spielberg	movie
find movies directed by steven spielberg	movie
find steven spielberg movies	movie
i want to find movies directed by stephen speilberg	movie
list all steven spielberg movies	movie
please find the movies by steven spielberg	movie
show films by steven spielberg	movie
show steven spielberg movies	movie
show steven spielberg movies	movie
steven spielberg movies	movie
steven spielberg pictures	movie
what movies has steven spielberg done	movie
find movies directed by steven spielberg	movie
movie by steven spielberg	movie
movie stuff for steven spielberg	movie
movies by steven spielberg	movie
movies directed by steven spielberg	movie
can i see what movies steven spielberg has done	movie
can you find movies with steven spielberg	movie
spielberg movies	movie
videos of steven spielberg	movie
find a list of movies directed by spielberg	movie
show me the movies that spielberg made	movie
can you please search for movies by steven spielberg	movie
find movies directed by stephen spielberg	movie
find movies directed by stephen spielberg	movie
i would like to search for movies directed by stephen spielberg	movie
list some movies directed by steven spielberg	movie
please find movies directed by stephen spielberg	movie
show me movies directed by steven spielberg	movie
show me the movies directed by steven spielberg	movie
which movies are from stephen spielberg	movie
gilda charles vidor	movie
show me movie gilda by charles vidor	movie
find some musical movies	movie
looking for a musical movie	movie
show me a list of musicals	movie
find the movie hum tum	movie
find movies directed by eddie murphy	movie
search movies by noah baumbach	movie
search chick flicks	movie
can you show me movies about war	movie
show me some war themed movies	movie
show movies concerning war	movie
please list movies about war	movie
list movies about war	movie
what movies are made by twentieth century fox television	movie
find movies directed by todd solondz	movie
find me movies with hugh jackman	movie
what ron howard movies are rated pg-13	movie
look for dramas made or shot in france	movie
find movies from france	movie
i want to see movies from france	movie
movies from france	movie
what are all the movies to come out of france	movie
give me a list of movies made in france	movie
i am looking for movies made in france	movie
i want to see a list of movies that were made in france	movie
i would like to view any movies made in france	movie
please show me movies made in france	movie
find movies from france	movie
find movies from france	movie
what movies were filmed in france	movie
find french films	movie
find french movies	movie
find french movies	movie
french movies	movie
i would like to see french movies	movie
list french movies	movie
look for french movies	movie
look up french movies	movie
show me french movies	movie
show me only french foreign films	movie
are there any french films showing	movie
show me mystery movies	movie
find movies produced by disney pixar	movie
show me pixar films	movie
find movies produced by lucas films	movie
i would like to find movies starring the singer mario	movie
look for movies starring the singer mario	movie
search for movies starring the singer mario	movie
bring up all diving movies	movie
bring up all diving related movies	movie
show me all movies about diving	movie
show me diving movies	movie
sort in all diving movies	movie
what is the plot of vulgaria	movie
find movies by mosfilm	movie
search for movies that were produced by mosfilm	movie
what films deal with immigrants in america	movie
look for cher movies	movie
show me cher movies	movie
eva mendes films	movie
the god father	movie
i need a list of tom hanks movies	movie
i want to view only movies with tom hanks	movie
i want to watch movies with tom hanks	movie
list tom hanks movies for me	movie
movies with tom hanks	movie
show me tom hanks movies	movie
show tom hanks movies	movie
tell me what movies tom hanks star in	movie
tom hanks movies	movie
watch tom hanks	movie
what other movies did tom hanks star in	movie
find movies produced by morgan freeman	movie
producer tom hanks movies	movie
what did tom hanks produces	movie
find movies directed by oliver stone	movie
find oliver stone directed movies	movie
i need movies directed by oliver stone	movie
please provide movies directed by oliver stone	movie
show movies directed by oliver stone	movie
name all of the movies john singleton has directed	movie
what are all of the movies that john singleton has directed	movie
show me movies in greek	movie
are there any movies in greek	movie
can i see all movies starring alan rickman	movie
show me movies with alan rickman	movie
show movies charlie sheen	movie
funny pg thirteen movies	movie
find movies produced by albert ruddy	movie
please look up movies produced by albert ruddy	movie
list all movies produced by alfred ruddy	movie
search for movies produced by albert ruddy	movie
what movies has albert ruddy produced	movie
what movies have albert ruddy produced	movie
which movie was produced by albert rudy	movie
which all movies are produced by yash chopra	movie
the camp out	movie
get all brad pitt produced movies	movie
what movies have brad pitt produced	movie
what movies were produced by brad pitt	movie
find movies starring halle berry	movie
look for films with halle berry	movie
search movies in which halle berry acted	movie
films by mel gibson	movie
search movies made by mel gibson	movie
movies by mel gibson	movie
show me a list of movies directed by mel gibson	movie
is this movie a romance	movie
home this movie is in english	movie
hope this movie is in english	movie
i hope this movie would be in english	movie
need to provide more info about the movie content	movie subjects
was what tom cruise 's first movie	movie
is the other guys a comedy	movie
what movies have robert deniro produced	movie
find me a list of movies directed by james cameron	movie
find movies directed by james cameron	movie
i want to find movies by director james cameron	movie
list all of the movies directed by james cameron	movie
list movies directed by james cameron	movie
watch james cameron movies	movie
can you show me a list of all the movies directed by james cameron	movie
show me a list of all the movies directed by james cameron	movie
show me other movies produced by james cameron	movie
show me the movies that james cameron has produced	movie
find me some warner bros. movies	movie
i want to see movies produced by warner bros	movie
show me a list of all warner bros. films	movie
show me all films produced by warner bros.	movie
show me the movies produced by warner bros	movie
what are the films that warner bros. produced	movie
i need to see some movies from warner brothers	movie
search for warner brothers movies	movie
i would love to see some movies produced by the wb	movie
what movies has jj abrams procuced	movie
show recent films starring bruce willis	movie
list recent films with actor bruce willis	movie
find john cusack movies	movie
get john cusack movies for me	movie
look for john cusack movies	movie
look for wes anderson films	movie
i would like to know the names of all the movies which have george clooney in them	movie
which are some of the movies that have george clooney in them	movie
show me some films produced by jon landau	movie
about finding nemo	movie
about finding nemo	movie
about finding nemo	movie
all about finding nemo	movie
detail finding nemo	movie
find me more about finding nemo	movie
finding nemo	movie
finding nemo	movie
finding nemo details please	movie
finding nemo info	movie
how can i get more information on finding nemo	movie
i need general information on finding nemo	movie
i would like to see finding nemo 's page	movie
information on finding nemo	movie
information on finding nemo	movie
look up finding nemo	movie
open page for finding nemo	movie
please find me some info on finding nemo	movie
run a search for finding nemo for me please	movie
show details of the original finding nemo	movie
show finding nemo	movie
show me finding nemo	movie
show me finding nemo 's page	movie
show me the official site for finding nemo	movie
synopsis for finding nemo	movie
synopsis for finding nemo	movie
where can i find information on finding nemo	movie
about the campaign	movie
i would like to get all the information about the the campaign	movie
run a search for the campaign	movie
the campaign	movie
what is the campaign about	movie
show me apollo thirteen	movie
frank capra movies	movie
find movies produced by castle rock entertainment	movie
what movies does jake gyllenhaal star in	movie
get a list of movies with kristen stewart	movie
kristen stewart top movies	movie
show me all movies kristen stewart has been in	movie
what movies have kristen stewart done	movie
which movies has kristen stewart been in	movie
list movie info kristen stewart	movie
find movie info kristenn stewart	movie
movie info kristen stewart	movie
show lionsgate director movies	movie
display movies made by production lionsgate	movie
i want to see a list of lionsgate movies	movie
lionsgate films	movie
lionsgate list	movie
lionsgate movies	movie
list lionsgate movies	movie
search for lionsgate movies	movie
what movies has lionsgate done	movie
michelle phifer movie list	movie
find danish movies	movie
show me the movies acted by chiranjeevi	movie
what movies has charles vidor directed	movie
what other movies die charles vidor direct	movie
show me all movies by charles vidor	movie
i 'd like to see foreign films	movie
search for foreign movies	movie
what are some universal pictures films	movie
show me all the movies made by universal	movie
find historical movies	movie
display the films by 7 arts	movie
show movies done by 7 arts	movie
can you show me a korean movie	movie
find korean movies	movie
korean movie	movie
show me korean movies	movie
i want to watch a korean movie	movie
find all rated pg-13 movies with eddie murphy	movie
twentieth century fox movies since 1990	movie
can you show me movies starring denzel washington please	movie
i want to see movies starring denzel washington	movie
please show me movies starring denzel washington	movie
show me movies starring denzel washington	movie
all the movies by kareena	movie
find movies of kareena	movie
kareena 's movies	movie
look for kareena 's movies	movie
find prison break movies	movie
find movies produced by spike lee	movie
has spike lee produced any films	movie
search for movies produced by spike lee	movie
give me a list of woody allen films	movie
show all movies directed by woody allen	movie
woody movies	movie
please find all movies woody allen has directed	movie
what movies were directed by woody allen	movie
which movies does gabrielle union come out in	movie
give me anything directed by robert wise	movie
list all robert wise movies	movie
show me a list of movies directed by robert wise	movie
what are all of the movies directed by robert wise	movie
list all of the movies that have been directed by robert wise	movie
what are all movies produced by chris nolan	movie
show me movies in german	movie
display movies in german	movie
do you have in movies in german	movie
i only want to see movies in german	movie
watch movies in german language	movie
find films in german	movie
get german language films	movie
show movies in german	movie
show back to the future movies	movie
show me back to the future movies	movie
movie results for back to the future	movie
show me a list of movies that christian bale has starred in during his career	movie
what are all of the movies acted in by the actor christian bale	movie
what are all the movies played in by chrisian bale	movie
what movies has christian bale acted in	movie
what movies has christian bale appeared in	movie
what movies have christian bale played in	movie
what movies and upcoming movies will christian bale star in	movie
find me movies by jj abrams	movie
brad pitt movie now	movie
brad pitt movies	movie
can you please list all movies with brad pitt	movie
can you please list all movies with brad pitt	movie
can you please list the movies brad pitt has acted in	movie
can you show me a movie with brad pitt	movie
i want to watch movies with brad pitt	movie
list all brad pitt movies	movie
list all brad pitt 's movies	movie
list brad pitt movies	movie
look for movies with brad pitt in them	movie
movie with brad pitt	movie
show all brad pitt movies	movie
show brad pitt movies	movie
show me brad pitt movies	movie
show movies with brad pitt	movie
what movie brad pitt in	movie
what movies have brad pitt	movie
sort by all brad pitt movies	movie
what movies did tom hanks direct that he also starred in	movie
show me a list of all movies directed by tom hanks starting with newest to oldest	movie
angelina jolie 's latest movie	movie
movies from scotland	movie
give me a list of r rated movies	movie
i want to look for movies with an r rating	movie
i want to see all movies with a r rating	movie
please look up r rated movies	movie
rate r movies for adult enterainment	movie
show me all r-rated movies	movie
show me movies that are rated r	movie
find movies with r ratings	movie
find rated r movies	movie
i want to find movies rated r	movie
i want to view movies that are rated r	movie
look up r rated movies	movie
movies with r rating	movie
r-rated	movie
r rated movies	movie
show me movies with a rating of r	movie
what are a list of movies with an r rating	movie
are there any movies that are rated r	movie
compile a list of movies with a r rating	movie
i want an r rated movie	movie
list all rated r movies	movie
r rated movies	movie
search for r rated movies	movie
show me a list of movies with r rating	movie
show me all rated r movies	movie
show me r movies	movie
show me r rated movies	movie
show only rated r movies	movie
what are movies that have a r rating	movie
which movies are rated r	movie
what other videos does the country norway have	movie
a showing of movies that are in spanish	movie
can you find movies in spanish	movie
search for movies in spanish	movie
spanish language movies	movie
i am looking for movies in spanish	movie
i would like to watch movies that are spoken in spanish	movie
list of movies in spanish	movie
show me movies in spanish	movie
can you show me a list of movies in spanish	movie
find movies in spanish	movie
find movies in spanish	movie
give me movies in spanish	movie
i would like a list of movies that have been made in spanish	movie
movies in spanish	movie
please make a list of movies that have been made in spanish	movie
send me movies that are in spanish	movie
show me movies in spanish	movie
show me movies that are in spanish	movie
give me swedish films	movie
show me mexican films	movie
show me movies made in south africa	movie
list some sci fi movies	movie
show me scifi fantasy movies	movie
find scifi films	movie
list scifi	movie
what movies did matt damon appear in	movie
sound of music robert wise	movie
can i watch a terry george film tonight	movie
get a list of animated films	movie
show me movies that are about scary zombies	movie
is there a movie about the zombie apocolypse	movie
i want to see a list about zombie horror films	movie
find some zombie movies	movie
find zombie movies	movie
get list of zombie movies	movie
give me a list of zombie movies	movie
i want to find zombie movies	movie
i want to see zombie movies	movie
see zombie movies	movie
show me zombie movies	movie
show me zombie movies	movie
show zombie movies	movie
zombie movie favorites	movie
find me a movie with zombies	movie
show me movies about zombies	movie
show me movies about zombies	movie
show me movies about zombies	movie
show movies of zombies	movie
which movies are based on zombies	movie
which movies have zombies in them	movie
movies about zombies	movie
display movies of zombies	movie
get movies about zombies	movie
movies about zombies	movie
i want scary zombie movies	movie
i want to see zombie movies that are scary	movie
find movies directed by niel abramson	movie
zombies	movie
what movies are directed by ridley scott	movie
i want to see movies directed by ridley scott	movie
german movie info	movie
i want to watch a german movie	movie
info german movie	movie
show german movies	movie
find action movies	movie
looking for an action movie	movie
what is the ratings of action movies	movie rating
movies patrick swayze played in	movie
show me a movie that starred patrick swayze	movie
show me short films	movie
movies by george lucas	movie
list of all dutch movies	movie
please give me a dutch movie listing	movie
dutch movie listing	movie
show me childrens movies	movie
movies tom cruise produced	movie
what movies did harry weinstein produce	movie
i want to look for movies produced by morgan freeman	movie
i would like to find movies produced by morgan freeman	movie
look for movies produced by morgan freeman	movie
search for movies produced by morgan freeman	movie
what movies are in bengali	movie
meryl streep movies	movie
movies frances ford copolla	movie
what movie did victor fleming direct	movie
movies from russia	movie
search for films produced in russia	movie
find movies produced in russia	movie
find all details about star wars - a new hope movie	movie
show all details about star wars - a new hope movie	movie
get me information about the movie star wars four	movie
can you show me details about the movie star wars : episode four - a new hope	movie
give me detailed information about the movie star wars : episode four - a new hope	movie
i would like to get some information about the movie star wars : episode four - a new hope	movie
list star wars movie a new hope	movie
find info about star wars episode four	movie
get me info on star wars episode four	movie
get me star wars episode four details	movie
i want to see info about star wars four	movie
run a search for star wars four	movie
show me star wars four	movie
show me star wars four page	movie
star wars four	movie
take me to star wars four page	movie
where can i watch star wars four	movie
tell about star wars iv	movie
what is full name of star wars iv	movie
darth vader	movie
han solo	movie
i only want movies by sidney lumit	movie
movies with sally field	movie
can you please open page about in july movie	movie
display details of in july movie	movie
exhibit details of in july movie	movie
in july movie page	movie
about movie in july	movie
find me the film in july	movie
show information for the movie title in july with moritz bleibtreu	movie
give me details about the movie in july	movie
i want information about the movie in july	movie
i would like to get detailed information about the movie in july	movie
search the movie in july	movie
show data for the movie in july	movie
show me detailed information about the movie in july	movie
show me more details for the movie in july	movie
check movie in july information	movie
display information for the movie in july	movie
i want to see anne hathaway 's latest movie	movie
show me anne hathaway 's latest movie	movie
show me hathaway 's recent movies	movie
what movies has jack black been in	movie
angelina jolie movies	movie
in which movies has angelina jolie starred	movie
list of movies starring angelina jolie	movie
movies with angelina jolie	movie
show angelina jolie movies	movie
show me all movies for angelina jolie	movie
show movies with angelina jolie	movie
what movies has angelina jolie been in	movie
which movies has angelina jolie been in	movie
list movies starring angelina jolie	movie
list movies with angelina jolie in them	movie
funny kids movies	movie
movies about basketball	movie
can you locate movies produced by clint eastwood	movie
can you show movies produced by clint eastwood	movie
find all movies produced by clint eastwood	movie
i am looking for movies produced by clint eastwood	movie
i need a list of movies produced by clint eastwood	movie
please find movies produced by clint eastwood	movie
will you provide a list of movies produced by clint eastwood	movie
i want to see more movies with katie holmes	movie
find any movies about horses	movie
what are some current movies with horses as the main topic of the movie	movie
johnny depp movies	movie
bring up black swan production	movie
all the movies of karan johar	movie
karan johar 's movies	movie
find movies of karan johar	movie
movies of karan johar	movie
find director movies	movie director
find a list of directors and their movies	movie director
movies and who directed them	movie director
bring up all director movies	movie director
list director movies	movie director
show movies directed by	movie director
i want to look up information about the movie hotel transylvania	movie
will ferrell been in	movie
what has will ferrell done	movie
find movies about gambling	movie
find movies about ice skating	movie
generate a list of movies about ice skating	movie
list ice skating movies please	movie
are there any movies with ice skating	movie
please show me movies about ice skating	movie
search for movies about ice skating	movie
are there any movies with skating on ice	movie
find dreamworks movies for kids	movie
where can i see a list of movies produced in great britain	movie
taye diggs films	movie
about house at the end of the street	movie
find me info on house at the end of the street	movie
house at the end of the street movie info	movie
i would like to see house at the end of the street information	movie
overview of house at the end of the street	movie
show me house at the end of the street	movie
show me the page about house at the end of the street	movie
get me info about the movie house at the end of the street	movie
show information for the movie house at the end of the street	movie
show me detailed information about the movie house at the end of the street	movie
show me more details for the movie house at the end of the street	movie
can you give me detailed information about the movie house at the end of the street	movie
dispaly info for movie house at the end of the street	movie
display overview of the movie house at the end of the street	movie
i need information about the cast reviews story etc in detail about the movie house at the end of the street	movie
send me movies that are in chinese	movie
i want chinese language movies	movie
show me movies in chinese	movie
find all chinese language movies	movie
look up movies in chinese	movie
movies in chinese	movie
show me movies produced by julian fellows	movie
julian fellows productions	movie
can you please search movies of tom cruise	movie
find movies with tom cruise	movie
find movies with tom cruise in them	movie
in what movies tom cruise is	movie
movies starring tom cruise	movie
show me all movies tom cruise has been in	movie
tom cruise movies	movie
tom cruise movies	movie
what movies has tom cruise been in	movie
what movies has tom cruise starred in	movie
find movies produced by george lucas	movie
find movies produced by george lucus	movie
give me a list of movies produced by george lucas	movie
give me a list of movies that george lucas produced	movie
locate all movies produced by george lucas	movie
list of dax shepard movies	movie
yash chopra 's movies	movie
find movies of yash chopra	movie
trouble with the curve was based on what	movie
what was the last film robert redford produced	movie
movies about immigration	movie
dawn of the dead movie information	movie
search the campaign movie	movie
show me information related to the film the campaign	movie
will you please show me info on the movie the campaign	movie
the campaign movie page	movie
i want to see info on the movie the campaign	movie
look up movie the campaign	movie
please show me info on the movie the campaign	movie
show me information for the movie the campaign	movie
tell me about the movie the campaign in detail	movie
can you show me details about the movie the campaign	movie
find movies about love	movie
movies about nature	movie
show me the comedy pitch perfect	movie
show me the movies produced by reliance	movie
which movies are family friendly	movie
can you get me a pg movie list	movie
find a pg rated movie	movie
find rated pg movies	movie
give me some good pg moives	movie
i am looking for movies that are rated pg for family movie night	movie
i need to see a list of pg movies	movie
i need to see all pg movies	movie
movies rated pg	movie
pg movies list please	movie
please show a list of recent movies rated pg	movie
show me movies rated pg	movie
bring up all pg movies	movie
find me pg movies	movie
find movies rated pg	movie
find movies that are pg	movie
i need movies with a pg rating	movie
i want to search for pg rated movies	movie
list movies rated pg	movie
movies with pg rating	movie
movies with pg rating	movie
pg movies	movie
show me pg rated movies	movie
show me the movies rating pg	movie
find movies with pg ratings only	movie
i want a list of pg rated movies	movie
i want to see movies that are rated pg	movie
only show movies rated pg	movie
please find pg rated movies	movie
search for movies with a pg rating	movie
search for movies with a pg rating	movie
show me all pg movies	movie
show me movies with pg rating	movie
show me movies with pg ratings	movie
show me pg movies	movie
get hungarian films	movie
i want to watch a comedy made in hungary	movie
show me hungarian comedies	movie
what 's the latest on brad pitt	movie
i 'm looking for a jason cortlund movie	movie
show me the movie now forager	movie
what old movies are made by warner brothers	movie
i want to look up alfred hitchcock movies	movie
find me movies made by alfred hitchcock	movie
i want to search for alfred hitchcock movies	movie
i would like to watch an alfred hitchcock movie	movie
show me some alfred hitchcock movies	movie
look up alfred hitchcock movies	movie
movies alfred hitchcock	movie
movies by alfred hitchcock	movie
movies by alfred hitchcock	movie
what movies has alfred hitchcock directed	movie
hitchcock movie list	movie
list hitchcock movies	movie
movie list hitchcock	movie
show me hitchcock movies	movie
hitchcock movie info	movie
hitchcock movies	movie
what movies did hitchcock direct	movie
show me the last five films for lionsgate	movie
show me recent movies from lionsgate	movie
what new movies does lionsgate have out	movie
show me the movie vulgaria	movie
what recently released movies are rated r	movie
get me a list of current r-rated movies	movie
show a list of recent releases that are rated pg	movie
what are some recent released pg movies	movie
show recent movies rated pg	movie
will you show me a list of recent movies rated pg	movie
which current movies are rated pg	movie
do you have anything by george cukor	movie
what was the first movie steven spielberg directed	movie
did rob reiner direct any movies	movie
what was the highest making movie	movie
show me high grossing movies	movie
what movies made the most money	movie
what are the top grossing movies	movie
find the new will ferrell movie	movie
what are the three latest films with will ferrell	movie
what are recent films by will ferrell	movie
any new movies with eddie murphy	movie
i would like to look for movies about god	movie
look up movies about god	movie
i want to look for movies about god	movie
please search for movies about god	movie
watch ron howard 's latest movie	movie
find ron howard new movie	movie
i need a list of movies produced by ray stark	movie
show me all movies produced by ray stark	movie
what movies has ray stark produced	movie
what movie has albert brooks done lately	movie
recent movies by steven spielberg	movie
find sandra bullock 's latest movie	movie
i am looking for movies directed by tom hanks	movie
find movies directed by tom hanks	movie
show me movies that tom hanks directed	movie
movies by tom hanks	movie
show me a list of all movies that were directed by tom hanks	movie
what movie made the least money	movie
what has tom cruise acted in lately	movie
what new movies are playing with rating of pg thirteen	movie
show me a list of movies that are new and rated pg-13	movie
what pg-13 movies are currently showing	movie
what other movies has will smith directed	movie
show me the latest movies in kannada	movie
have any new movies by twentieth century fox	movie
current movie suggestions	movie
show me new releases	movie
see ed harris last movie	movie
give me a list of recent horror films	movie
show me movies in swedish	movie
what was woody allen 's last movie	movie
about in july	movie
i want to go to the homepage for in july	movie
i want to view the page on in july	movie
i would like to see the main page of in july	movie
in july information	movie
summary of in july	movie
synopsis for in july	movie
was life is beautiful made in italy	movie
current movies rated g	movie
find all new releases that are rated g	movie
can i have a list of movie production companies	organization
who is bruce willis	person
producer	person
i need a movie producer list	person
can i have a list of producers	person
find me info on emma watson	person
show me more information about will smith	person
will smith bio	person
i need a list of actors	person
search for actors	person
find actors	person
search movie actors	person
movie actors	person
display actors in movies	person
show actors in movies	person
display biography of actor will ferrell	person
who is the actor will ferrell	person
director	person
find a director	person
find directors	person
search directors	person
search directors	person
movie directors	person
give me a list of directors	person
where can i find a director	person
see bill paxton	person
give me information about elizabeth mcgovern	person
show me information on darla anderson	person
can you give me more information about charles	person
can you tell me more about the producer ray stark	person
give me more details about the producer ray stark	person
i need to know more about the producer ray stark	person
show me more information about the producer ray stark	person
show me information on shelly long	person
i want to know about clint eastwood	person
look for information about charles vidor	person
search for information about charles vidor	person
want to see charles vidor	person
who is childs vidor	person
find me more information on scorscese	person
find the director andrew stanton	person
who is andrew stanton	person
see the olsen twins	person
can you find more information on albert ruddy	person
search for information about tom cruise	person
find information about tom cruise	person
look for information about tom cruise	person
look up information about tom cruise	person
all about will farrell please	person
bio on will ferrell	person
biography for will ferrell	person
bring me to will ferrell informaion	person
bring up a bio on will ferrell	person
can you show me information on will ferrell please	person
display all information on will ferrell	person
get me bio info for will ferrell	person
goto will ferrell biography	person
i want information about will ferrell	person
i want to see will ferrell details	person
information about will ferrell	person
look for will ferrell	person
open a page about will ferrell	person
please show me information on will ferrell	person
search for will ferrell	person
show me a bio of will ferrell	person
show me will ferrell information	person
show will ferrell information	person
who is will ferrell	person
who is will ferrell	person
who is will ferrell	person
will ferrell	person
will ferrell history	person
will ferrell tidbits	person
will ferrell 's biography	person
please run a search on will ferrell and display all info returned	person
what is terry georges background	person
exhibit all relevant information about the director steven spielberg	person
show me the bio for the director steven spielberg	person
who is director steven spielberg	person
show all relevant information about the director steven spielberg	person
show biography for director steven spielberg	person
find information about kristen stewart	person
how do i find out information about kristen stewart	person
learn more about kristen stewart	person
who is kristen stewart	person
information on julia roberts	person
get me information about spielberg	person
i want to know about spielberg	person
i want to see spielberg 's page	person
pull up spielberg	person
show me spielberg 's info	person
show me spielberg 's main page	person
show me the profile of spielberg	person
show my spielberg info	person
find me stats about steven spielberg	person
i need details steven spielberg now	person
search for steven spielberg	person
show me the information for steven spielberg	person
stephen spielberg biography	person
steven spielberg	person
steven spielberg bio	person
steven spielberg profile page	person
what about steven spielberg	person
who is steven spielberg	person
find info on tom hanks	person
show me information on tom hanks	person
show tom hanks	person
information for sally field	person
sergio leone	person
i need information on sean connery	person
tell me about michelle pfiefer	person
i want to learn about charlie sheen	person
find information about robert wise	person
robert wise life	person
search for information about robert wise	person
director 's profiles : hitchcock	person
warner brothers bio	person
alfred hitchcock	person
who is hitchcock	person
information for clark gable	person
i want information about angelina jolie	person
i want more information on richard lester	person
information for vivian lee	person
name the producer of the godfather	person_name
what is the name of the company that produced sparkle	person_name
what is the name of the company that produced the movie ants	person_name
show me the name of the producer of the movie avatar	person_name
can you show me the name of the producer for cabin in the woods	person_name
what is the name of the company that produced the movie avatar	person_name
please provide the name of the company that produced sparkle	person_name
what is the name of the company that produced the movie inception	person_name
hitch list producer	producer
i want info on how produced hitch	producer
who are the producers for the movie hitch	producer
who is the producer for hitch	producer
who produced hitch	producer
who produced hitch	producer
who produced hitch	producer
who was the producer for the movie hitch	producer
info hitch producer	producer producer
what production company was responsible for the film the devil wears prada	producer
what company produced secretariat	producer
what company produced the movie field of dreams	producer
what company produced jurassic park	producer
company that produced iron man	producer
what company produced cabin in the woods	producer
production company for spiderman	producer
who produced cabin in the woods	producer
what was the production company for black swan	producer
get me the think like a man movie producer	producer
who produced cars	producer
who produced cars	producer
who produced the movie cars	producer
who produced steel magnolias	producer
who produces steel magnolias	producer
name of producer for ghost busters	producer
who produced et	producer
who was the producer for elizabeth	producer
please show me who produces madagascar	producer
look for the producer of heroine	producer
producer of heroine	producer
can you find the producer of heroine	producer
can you tell me who produced the movie avatar	producer
i need to know the movie avatar 's producer name	producer
i need to know who produced the movie avatar	producer
please tell me who produce the avatar	producer
producer of avatar	producer
who is the producer of avatar	producer
who produce the avatar	producer
who produced avatar	producer
who produced avatar	producer
who produced avatar	producer
who produced avatar	producer
who produced avatar with james cameron	producer
who is listed as producer of grease	producer
who is the producer of grease	producer
browse lionsgate information	producer
display production company lionsgate	producer
get info on lionsgate	producer
goto lionsgate	producer
i would like more information about lionsgate	producer
look for information about lionsgate	producer
see lionsgate info	producer
show lionsgate	producer
company that produced the avengers	producer
show who produced black swan	producer
who produced black swan	producer
who produced spaceballs	producer
find the producer of the godfather	producer
show me the producer of the godfather	producer
who is the producer of the godfather	producer
who produced the godfather	producer
who produced the godfather	producer
who produced the godfather	producer
who produced the godfather movies	producer
producer for slumdog millionaire	producer
company that produced thor	producer
what company produced days of thunder	producer
i want to look for information about paramount studios	producer
look for information about paramount studios	producer
what is the history behind paramount	producer
look at paramount	producer
who produced hotel rwanda	producer
who produced the movie hotel rwanda	producer
who produced titanic	producer
company that produced twilight	producer
producer for ms. congeniality	producer
who produced top gun	producer
what production company produced the movie avatar	producer
what studio made the dark knight	producer
what company produced the hangover	producer
who produced the devil wears prada	producer
i d like to know who the producer of the terminator is	producer
i wonder who produced the terminator	producer
who is the producer of the terminator	producer
find producer of the great debaters	producer
who produced the great debaters	producer
who produced the movie twilight	producer
production company for the hulk	producer
can i see who produced possesion	producer
who produced possesion	producer
find the producer of moby dick	producer
producer for the passion of the christ	producer
who produced what to expect when you 're expecting	producer
what company is the producer of inception	producer
who produced the movie the dark knight	producer
who produced lion king	producer
i would like to find the producers of the lion king	producer
what company produced sparkle	producer
which company produced the terminator	producer
who produced casino royale	producer
search mgm studios	producer
who was the producer for the amazing spiderman	producer
in the movie ants who is the producer	producer
the movie ants was produced by what person	producer
the producers for the movie ants	producer
who is the producer for the movie ants	producer
find the producer of gone with the wind	producer
producer for gone with the wind	producer
who produced the movie gone with the wind	producer
who produced the movie	producer
who produced the movie	producer
who produced this movie	producer
search for the producer of mirror	producer
who was mirror 's producer	producer
person produced the blind side	producer
who was the producer for coming to america	producer
search for the producer of step up	producer
goto warner brothers	producer
pixar film studio	producer
look up the producer of freedom writers	producer
who produced godfather	producer
who produced the godfather	producer
show producers who work for miramax	producer
what type of audience can watch cars	rating
is toy story for kids	rating
rating of movie	rating
what is movie rated	rating
show me the film rating	rating
is this movie suitable for small children	rating
show me the rating for the movie	rating
what is the mpaa rating for movie	rating
what is the reccommended audience for movie	rating
can i see this film rating	rating
what is the parental rating on this movie	rating
what is the rating of movie	rating
movie rating	rating
what rating did the dark knight rises receive	rating
what is the rating for dark knight	rating
rating for dark knight	rating
can you tell me whats the rating of movie avatar	rating
i need to know the rating of the movie avatar	rating
show me the rating of the movie avatar	rating
what is the rating for the movie ants	rating
is hotel transylavania good for adults	rating
show me the rating for the movie the lord of rings	rating
what age is marley and me appropriate	rating
how old should a person be to watch marley and me	rating
what age is appropriate to watch marley and me	rating
what rating is superman	rating
rating for transylvania	rating
tell me the rating of the movie grease	rating
what is grease rated	rating
tell me the rating of the film grease	rating
what is the appropriate age for clueless	rating
what is the rating of dirty dancing	rating
what is the rating for dirty dancing	rating
what rating is freedom writers	rating
what is the rating for house at the end of the street	rating
what ratings does the house at the end of the street hold	rating
is it appropriate to take my 16 year old to see land of the lost	rating
is the movie life is beautiful ok for my six year old to watch	rating
find the rating of the movie step up	rating
rating for the green hornet	rating
show me the film rating for avengers	rating
show rating for the film avengers	rating
show rating of movie avengers	rating
what is the rating for the avenger movie	rating
rating for the avengers	rating
what is jurassic park rated	rating
list movie ratings for us movie looper	rating
show movie ratings for us movie looper	rating
what audience will watch black swan	rating
how is a good man in africa 's rating	rating
can i take my 13 year old to see american pie	rating
how old for black swan	rating
what age is black swan appropriate for	rating
can you tell me the rating for cabin in the woods	rating
i would like to know the rating for cabin in the woods	rating
kindly show me the rating for cabin in the woods	rating
show me the rating for cabin in the woods	rating
rating for resident evil	rating
show me the rating for the movie romeo must die	rating
what 's the rating for satyricon	rating
what restrictions does the campaign film have for viewers	rating
what is the rating for the movie the campaign	rating
show me the rating for the movie the expendables 2	rating
show me the rating for the movie the mechanic	rating
can you find out what the movie dredd is rated	rating
look up the rating for the movie dredd	rating
search for the rating of the movie dredd	rating
what is the movie rating for die hard	rating
twilight revenue	revenue
what was the gross profit for twilight	revenue
how much did et gross worldwide	revenue
what did et gross	revenue
what were et 's revenues	revenue
can you tell me about the revenue generated by the movie avatar	revenue
how much money did avatar make	revenue
how much revenue did the movie avatar generate	revenue
tell me about the revenue generated by the movie avatar	revenue
how much money did pretty woman take in	revenue
revenue for pretty woman	revenue
gross earnings for avengers movie	revenue
ticket sales for the movie avengers	revenue
what was the gross earnings for the avengers movie	revenue
how much revenue did the avengers take it	revenue
what were the gross receipts for the avengers	revenue
can you give me the revenue of the movie titanic	revenue
how much revenue did titanic make	revenue
profits made by titanic	revenue
revenue for titanic	revenue
revenue for titanic	revenue
total titanic revenues	revenue
what was the revenue for toy story 3	revenue
dark knight revenue	revenue
how much did the dark night generate	revenue
can i see the lion king 's revenue	revenue
can i see what the lion king 's revenue was	revenue
show me the lion king 's revenue	revenue
what was the lion king 's revenue	revenue
how much did jurassic park make	revenue
how much money did finding nemo make	revenue
what did the movie finding nemo gross	revenue
how much did the transformers make in revenues	revenue
revenue for transformers	revenue
how many minutes is finding nemo	runtime
how many minutes is in july	runtime
how many minutes is star wars four	runtime
what is the length of the sound of music	runtime
how long is the movie	runtime
how many minutes is life is beautfiul	runtime
how long is the movie the campaign	runtime
what is avatar about	subjects
what was star wars four about	subjects
what is movie about	subjects
who wrote this movie	writer
actor from forrest gump lieutenant dan	actor
actor who played stephanie in full house	actor
what female played as number 13 in the tv show house	actor
what actress starred in i love lucy as ethel	actor
who played beaver in leave it to beaver	actor
can you tell me the name of the actor who played todd in the tv show one life to live	actor
give me the name of the tv actor who played todd on one life to live	actor
i need to know the name of the tv actor who played todd on show one life to live	actor
find who guy who was the red ranger in power rangers	actor
who is the guy who played the red ranger in power rangers	actor
actress from reba who played kyra	actor
who plays luke skywalker in nineteen seventieseven starwars	actor
show me cast and crew for star wars	actor
list cast in that 's 70s show	actor
who starred in three 's company	actor
who was the antogonist in apollo thirteen	actor_name
what is the name of the african american actress who played in ghost	actor_name
i would like to know the name of the actor who played todd in the tv show one life to live	actor_name
name the actor who played opposite sidney pointier in shoot to kill	actor_name
what was the name of the actor who plays victor on young and the restless	actor_name
how much was the budget for e.t.	budget
find budget for epic	budget
what was the budget for the movie epic	budget
look for epic 's budget	budget
how much money did they spend to make finding nemo in 3d	budget
how much money did it cost to produce hotel transylvania	budget
i believe it cost a bundle to make hotel transylvania	budget
what was the budget for hotel translyvania	budget
what were the production costs for hotel transylvania	budget
budget for left behind	budget
how expensive was it to make looper	budget
how much did it cost to make looper	budget
what was the total cost of production for looper	budget
the movie mr and mrs smith reported making how much money	budget
what was the budget for nightmare on elm street	budget
how much was it to produce paranorman	budget
how much was the budget for paranorman	budget
what did it cost to make paranorman	budget
what was the budget for paranorman	budget
i want to know what the budget for posseion was	budget
what was the budget for puss in boots	budget
the budget of the russian movie return	budget
search for the budget of return	budget
what was the budget of return	budget
budget for snow white and the huntsman	budget
what was star wars budget	budget
show me the budget for terminator 1	budget
budget for amazing spiderman	budget
can you tell me the budget for cabin in the woods	budget
i am interested in finding out the budget for cabin in the woods	budget
i am trying to discover how much budget costs were for cabin in the woods	budget
show me the budget for expendables 2	budget
budget for the help	budget
show me the possession 's budget	budget
budget for twilight breaking dawn	budget
what country did the nine fourteen twenty twelve release of barfi come from	country
where is the film budbrigeren from	country
what country did downton abbey come from	country
what country is in the land of blood and honey	country
where did la moustache take place	country
where did they do les mes	country
where was les mes made	country
in what country was les miserables created	country
what country was les miserables made	country
where was les mes set	country
what is the country in which les miserable was made	country
where is resident evil located	country
where was the movie secrets and lies from	country
what country is the king is back	country
what country was the maid set in	country
when will barfi ! be released	release_date
list movie evil goes global on oh nine fourteen twenty twelve	release_date
when was finding nemo 3d released	release_date
what is the realase date for harry potter	release_date
when did harry potter come out	release_date
when is i am legend 2 going to be released	release_date
when the movie monster inc 2 will be released	release_date
what date does omg oh my god ! come out	release_date
find date omg	release_date
list date for omg	release_date
omg date	release_date
search date for omg	release_date
when will omg release	release_date
when was the movie omg oh my god ! released	release_date
what is the movie release date for omg oh my god	release_date
show movie omg on oh nine twenty eight twenty twelve	release_date
when will possed be released	release_date
when was resident evil three d released	release_date
when was star wars released	release_date
what year did robert wise direct sound of music	release_date
show me a list of german directors	director
who was the director of the movie crank 2	director
who directed daddy daycare	director
who was the director of the movie d-war	director
director of harry potter	director
who directed the 1st indiana jones	director
director of indiana jones movie	director
who directed return of the jedi	director
who directed roger rabbit	director
find the director of the santa clause	director
find the director of star wars	director
get me star wars director	director
i would like to know who the director of star wars was	director
show me the director of star wars	director
star wars director please	director
who directed star wars	director
who directed star wars	director
who directed the nineteen seventy seven star wars movie	director
i want to know who was the director of the movie star wars	director
director of taking of the pelham 1 2 3	director
who directed the good	director
who directed the good	director
who directed the simpsons movie	director
what are the names of directors from older classic movies	director
name star wars director	director_name
genre for downton abbey	genre
what genre of movie is omg oh my god	genre
what type of film is raiders of the lost art	genre
find out the genre for the movie the businessman	genre
what language is 9 women in	language
amelie is in what language	language
what language is amelie in	language
what tongue did they speak in black swan	language
what language is spoken in amelie	language
is the movie bastardos en el paraiso all in swedish	language
what language is the father of my children in	language
language of my annette	language
what language is spoken in the movie on a wednesday	language
name all movies made in america	movie_name
i need to get names of some thriller movies with pg thirteen rating	movie_name
can you tell me names of some movies by indian actor dilip kumar	movie_name
show me names of movies in which indian actor dilip kumar acted	movie_name
show me names of some movies about gardening	movie_name
can you show me names of some movies on religious issues	movie_name
i need to find names of some movies on religious issues	movie_name
get me the names of movies about sports figures	movie_name
i need names of some movies about gardening	movie_name
list release dates for all horror movies between 1995 and 2000	movie date
show me the earnings for clint eastwood movies	movie revenue
what has brad pitt directed	movie
classics	movie
find classics	movie
show me the comedies for sept	movie
i want to know all the comedies that warner brothers made in twenty eleven	movie
show all dramas that came out nine twenty one twenty twelve	movie
show all comedies that came out nine twenty eight twenty twelve	movie
show me a drama rated pg-13	movie
what legal comedy did will ferrel act in	movie
find classic car documentaries	movie
show garden documentaries	movie
i want to see something about wildflowers	movie
show all african movies for twenty eleven	movie
what are all movies made in america	movie
i would like to search for movies from asia	movie
show all danish movies in this decade	movie
what movies came out of russia last year	movie
show all british movies from two thousand one	movie
movies by mel gibson	movie
find movies directed by the man who played as john on chips	movie
can you please make a list of all movies brad pitt directed	movie
show me all brad pitt directed movies	movie
show all movies by darla k anderson	movie
watch darla anderson new movie	movie
what other films has george vidor done	movie
show movies directed by greenberg	movie
list the other films james lassiter has worked on	movie
john paul directed movies	movie
list of movies directed by john paul	movie
movies by director john paul	movie
show me the movies directed by r b choudary	movie
what is ray stark 's current movie he directed	movie
pull up a ray stark movie	movie
what other movies did ray stark do	movie
show ray stark movies	movie
has ray stark made other movies	movie
find a ron howard movie from 2012	movie
show me a sam wood and victor fleming film	movie
did teddy lee do a lot of movies	movie
what are the movies by director tom cruise	movie
what movies has tom cruise directed	movie
show me the movies directed by trivikram	movie
show movies directed by the zucker brothers	movie
find anime films from japan	movie
find some detective movies	movie
find some historical romance movies	movie
show all sy fi movies for twenty twelve	movie
what was the highest-grossing woody allen movie ever	movie
all movies that made above seven point five million dollars	movie
what movie made over forty million	movie
show me movies that made more than ten million	movie
i 'd like to see the film that made over twenty million dollars	movie
can you find me only movies that grossed three million or more	movie
what movies where released in aug of twenty eleven	movie
search for eighties movies	movie
what is the release date for the movie heroine	movie
what movies were released nine fourteen twelve	movie
where can i find a list of movies released nine fourteen twenty twelve	movie
i want you to pull up movies from nine fourteen	movie
what movies were released on nine twenty one twelve	movie
show me movies from the nineteen fifties	movie
search nineteen ninety 's movies	movie
show me films that came out in september of this year	movie
movies in september twenty twelve	movie
movies released in september twenty twelve	movie
what are some new movie releases for september twenty twelve	movie
get a list of movies released in september	movie
show me movies coming out in september	movie
show me movies released in september	movie
what movies came out in september	movie
what movies were released in september	movie
find movies released in september	movie
show me movies from the sixties	movie
what twenty twelve movies were rated pg	movie
give me a list of twenty twelve rated r movies	movie
twenty twelve twentieth century fox movies	movie
search twenty twelve movies	movie
i want a danish language speaking film	movie
are there any danish language films around	movie
movies in dutch	movie
showcase all movies in 2012 that are in french	movie
movies in french	movie
display a list of 2012 movies in german	movie
show me a hindi action movie	movie
show me the latest movies in malayalam	movie
what movies are their in portuguese	movie
see movies in punjabi	movie
search for movies in canada with james brown	movie
i want movies in france	movie
movies from paris	movie
show me movies from paris	movie
movies for twenty twelve based in spain	movie
look for movies acted in spain	movie
search movies acted in spain	movie
search movies acted in sweden	movie
i want to see a list of all movies in the usa	movie
show me movies in the usa	movie
what are the movies that alfred ruddy produced	movie
get movie information for lionsgate	movie
what movies did disney produce in 1998	movie
find dreamworks movies from twenty ten	movie
lionsgate movies for twenty thirteen	movie
show me all recent pg movies by paramount	movie
find films made by the company searchlight films	movie
show me the movies rating a	movie
find all movies rated g in the last year	movie
show all movies made in twenty eleven with g rating	movie
show nc seventeen movies for twenty eleven	movie
find sports movies rated pg	movie
list all movies rated pg and pg-13 released in 2009	movie
show all r movies for twenty eleven	movie
what r-rated movies were released in twenty twelve	movie
find detective movies rated r	movie
what movies are safe for a young child to watch	movie
show me brittney murphey movies	movie
get me movies with chloe sevigny	movie
show me all movies hillary duff has been in	movie
list only jason statham movies	movie
what movies did kelly brooke do	movie
what movies did meryl streep make in 2010	movie
show me the movies acted by namitha	movie
find movies with von sudow	movie
search for films with von sudow	movie
i would like to know in detail about the film career of indian actor dilip kumar	movie
show me movies that jennifer grey starred in from nineteen eighty seven	movie
what movie had katie holmes and scott wolf in it	movie
what is the movie with patrick swayze and jennifer grey	movie
find a movie about apartheid	movie
show me some movies about apartheid	movie
i want to see a movie about armstrong siddly	movie
what movies are filmed about asia	movie
show all movies about britian	movie
show me movies involving car chases	movie
do you have any movies about cars	movie
i want to see films involving cars	movie
i want to see movies about cars	movie
movies about cars	movie
find movies about church	movie
classic car movies	movie
show classic car movies	movie
show me movies about classic cars	movie
what movies have classic cars in them	movie
find movies about classic cars	movie
movies about classic cars	movie
movies about computers	movie
show me all movies from 2000 about dogs	movie
what foreign film involves dragons	movie
what is the latest movie out about esp	movie
i am really interested in esp and would like to see a movie	movie
i would love to see a movie about esp	movie
i wonder if there are any movies out about esp	movie
what movies were released in 2012 about ice skating	movie
list films concerning the country of france	movie
show me movies about france	movie
display movies concerning france	movie
list movies filmed on france	movie
display french culture films	movie
find movies about gardening and lawn care	movie
gardening movies	movie
i would like to know names of some movies related with gardening	movie
results for gardening movies	movie
i want to see movies about gardening	movie
show me movies about gardening	movie
show me movies on gardening	movie
show movies on gardening	movie
movies about gardens	movie
search for movies about hair	movie
find movies about haunting	movie
show me movies that talk about healthy eating	movie
give me a list of movies that discuss healthy eating	movie
give me a list of movies the deal with the topic of healthy eating	movie
the movie that has a kid who ages into a man	movie
titles of movies about libraries	movie
make a list of movies about libraries	movie
list movies about libraries	movie
search movies about the october revolution	movie
period movies	movie
search for movies about preschool boys	movie
race car movies	movie
show me a list of some movies on religious issues	movie
best space movie	movie
space movies	movie
list some sports movies	movie
show me movies about the future	movie
movies about the president	movie
are there any movies that have tips about gardening in them	movie
list of movies about unsolved crimes	movie
find movies about us government	movie
find war movies rated r	movie
what zombie movies are scheduled for release in twenty thirteen	movie
display movies on gardening	movie
show all movies with america in title	movie
pull up films with flowers in the title	movie
show me movies about gardening	movie
where can i find the movie amelie in french	movie
did tom hanks act in and produce apollo thirteen	movie
show me belle the movie is it in spanish	movie
search for despicable me in italian	movie
is et in french	movie
looking for et in french	movie
show movie evil goes global on oh nine fourteen twelve	movie
get finding nemo twenty oh three	movie
where can i find the movie garayh in punjabi	movie
did albert ruddy produce all of the godfather movies	movie
is this movie german	movie
is this movie directed by a norwegian	movie
is this movie scary	movie
are there any recent versions of gone with the wind	movie
is this movie in french	movie
is this movie in punjaki	movie
is this movie in turkish language	movie
was this movie filmed in china	movie
sergio leone good bad and ugly	movie
find goodfellas in german	movie
is a hard day 's night a documentary	movie
was the movie heroine released in september of twenty twelve	movie
can i have hotel transylvania three d	movie
house to akrend street	movie
show me the movie lionsgate	movie
download mission impossible in spanish	movie
i want to see mission impossible in spanish	movie
please show mission impossible in spanish	movie
show me mission impossible in spanish	movie
show mission impossible in spanish please	movie
list movie omg on oh nine twenty eight twenty twelve	movie
find pirates of the caribean in french	movie
is a seperation in french	movie
smurfs for the kids	movie
is there a sound of music two	movie
find me information about the first star wars	movie
is the nineteen seventieseven starwars movie rated pg	movie
show star wars movie	movie
show star wars movie list	movie
will 's in the hitch	movie
search for the hunger games in korean	movie
rated pg lion king info	movie
is toy story family friendly	movie
search for information about american movies	movie
show all horror movies that me out in twenty twelve	movie
where can i find information about movies released nine fourteen twenty twelve	movie
show me information about movies from liongate	movie
search disney pictures	organization
alberts bio	person
alberts family	person
show british actor jason stathon	person
arabic actors	person
give me a list of irish actors	person
name of company produced forrest gump	person_name
find the producer of a mom for christmas	producer
production company for amityville horror	producer
who produced the antwon fisher stoy	producer
who produced the movie caddy shack	producer
find the producer of lord of the flys	producer
who produced mirror by tarkovsky	producer
do you know who produced star wars	producer
i need to know who produced star wars	producer
who produced star wars	producer
who produced star wars	producer
name of company that produced the great debaters	producer
what studio produced lord of the rings	producer
think like a man the movie which company produce	producer
find period productions	producer
what movie rating is the anchorman	rating
is house at the end of the street ' ok for my six year old	rating
what is the rating for marley and me	rating
show me the movie rating for resident evil : retribution	rating
what ages is wall-e good for	rating
how much money did bananas make	revenue
how much revenue did bananas make	revenue
what was the total gross for the movie bananas	revenue
what was the revenue from beaches	revenue
find the revenue of big	revenue
find the revenue of black beauty	revenue
how much money did black swan bring	revenue
what was black swan 's revenue	revenue
how much revenue did bourne identity make	revenue
revenue for breaking dawn	revenue
how much did dark night make at the box office	revenue
show me the revenue created by dragon war	revenue
end of watch gross	revenue
how much did end of watch make in the box office	revenue
how much money did end of watch make in theaters	revenue
what is the revenue for fast and the furious	revenue
how much revenue did finding nemo 3d make	revenue
look for revenue from freedom writers	revenue
show me the revenue created by ghost rider spirit of vengeance	revenue
total revenue for ghostbusters	revenue
can you tell me the amount of money this movie made	revenue
how much did this movie earn	revenue
how much did this movie make	revenue
how much did this movie make	revenue
how much money did this movie accumalate	revenue
how much did movie make	revenue
what was revenue made from the movie great debaters	revenue
how much did harry potter and the sorcerer 's stone make	revenue
how much did hitch gross	revenue
how much money did hitch make	revenue
what was the box office gross in hitch	revenue
hotel translyvania box office numbers	revenue
how much did hotel transylvania gross	revenue
how much did hotel transylvania make in the box office	revenue
how much money did hotel transylvania gross overall	revenue
how much did house at the end of the street make	revenue
how much did house on the end of the street gross	revenue
revinue for I 'll be home for christmas	revenue
how much money did iron man gross	revenue
how much money did iron man make	revenue
what was the profit margin of iron man	revenue
find revenue generated by kahani	revenue
want to find the revenue of kahani	revenue
what was the revenue of kahani	revenue
what did the movie life is beautiful gross	revenue
dollars in sales looper	revenue
how many dollars did looper gross	revenue
how much did looper gross	revenue
how much did looper make in the box office	revenue
how much money did looper make	revenue
how much revenue has looper made	revenue
looper revenue	revenue
what were the box office sales for looper	revenue
how much did looper gross	revenue
what was men in black 3 's revenue	revenue
find the revenue of mirror	revenue
what is the box office of mirror	revenue
what is the revenue of mirror	revenue
revenue for ms. congeniality	revenue
can you please tell me about the revenue for the movie mr and mrs smith	revenue
find revenue from my boys	revenue
what was the revenue for pulp fiction	revenue
show me the revenue created by romeo must die	revenue
find how much money shark tales made	revenue
how much did shrek make	revenue
how much money did shrek bring in	revenue
what was shrek 's revenue	revenue
what were the earnings from signs	revenue
snow white and the huntsman revenue	revenue
how much money did star wars earn at the box office	revenue
how much revenue did star wars make	revenue
look for revenue from step up	revenue
please look up revenue from step up	revenue
what was the gross revenue for superman returns	revenue
box office total terminator 2	revenue
amazing spiderman revenue	revenue
how much revenue did the amazing spiderman make	revenue
can you tell me the revenue for cabin in the woods	revenue
how much revenue did cabin in the woods bring in	revenue
i am interested in what cabin in the woods made in revenue	revenue
kindly show me the revenue for cabin in the woods	revenue
the cabin in the woods revenue	revenue
show me the revenue created by the expendables 2	revenue
show me the revenue created by the expendables	revenue
find revenue generated by the help	revenue
how much was generated from the movie the help	revenue
how much did lord of the rings make	revenue
how much revenue did lord of the rings get	revenue
what is the revenue for lord of the rings	revenue
find the revenue for passion of the christ	revenue
what was the gross revenue for the princess bride	revenue
revenue for the way we were	revenue
how much did trouble with the curve gross	revenue
how much did trouble with the curve make	revenue
how much did trouble with the curve make in the box office	revenue
trouble with the curve profit	revenue
what is finding nemo about	subjects
what is the movie the campaign about	subjects
what is the movie the campaign about	subjects
show all italian movies made in twenty twelve	movie
show all russian movies made in the last five years	movie
show me all the russian films for twenty twelve	movie
look for english movies based in the uk	movie
i 'd like to see a movie that was filmed in africa	movie
who produces for fox movies	producer
which producers work for fox	producer
find movie based on criteria	movie_other
how often does he put movies out	movie_other
is finding nemo available on netflix	movie_other
is this movie for rent	movie_other
search by actor	movie_other
search by actor	movie_other
search by actor	movie_other
search by box-office rating	movie_other
search by director	movie_other
search by producer	movie_other
search by release date	movie_other
search by stars	movie_other
search by type	movie_other
searching for cheap movies	movie_other
searching for movie prices please	movie_other
show me the movie itself	movie_other
show page for moview	movie_other
where can i rent this movie	movie_other
find ratings	movie_other
are any of these directors dead	movie_other
are these directors still alive	movie_other
list comedians in the movies	movie_other
brazil info on movies	movie_other
can i buy this movie	movie_other
feature films	movie_other
find biographies	movie_other
find expensive movies online	movie_other
find specific movie	movie_other
most translated foreign film	movie_other
movie type	movie_other
movies coming to theatres soon	movie_other
find most popular actors	movie_other
look for the actor that sings let me love you	movie_other
bings stuff steven spielberg	movie_other
how directed alfred hitchcock shows	movie_other
are there sub-titles	movie_other
where is movies dialect from	movie_other
please look up and alfred movies	movie_other
is kristen stewart really dating robert pattinson	movie_other
is tom cruise getting a divorce	movie_other
is tom cruise married	movie_other
list women married to directors in the movies	movie_other
robert wise children	movie_other
where did spielberg go to school	movie_other
where does tom cruise live	movie_other
middle aged white actors	movie_other
what are the logos for popular production companies	movie_other
i want to find more movies like life is beautiful	movie_other
i want to watch movies like finding nemo	movie_other
like dirty dancing	movie_other
movies like in july	movie_other
movies like life is beautiful	movie_other
search for dramas like downton abbey	movie_other
show me related movies like in july	movie_other
show other movies similar to this	movie_other
what are some movies like the campaign	movie_other
what are sone other movies house at the end of the street	movie_other
what movies are like house at the end of the street	movie_other
what movies are related to dirty dancing	movie_other
what movies are related to in july	movie_other
what other movies are about the holocaust similar to life is beautiful	movie_other
what did steven spielberg do before he was a director	movie_other
what made darla anderson become a producer	movie_other
what was robert wise favorite part of directing the sound of music	movie_other
did looper come in second at twenty one mil	movie_other
actors considered for new movie	movie_other
find the actor with 4 r and b albums	movie_other
find the actor with the album entitled go	movie_other
i would like to look up the actor with the album entitled dna	movie_other
search for the actor that sings let me love you	movie_other
after watching this movie will i have nightmares about it	movie_other
show me the behind scenes look of how the movie was made	movie_other
show me videos of steven spielberg on the red carpet with his wife	movie_other
what movie came in second this weekend	movie_other
ed harris quotes from apollo thirteen	movie_other
how did robert wise get hired to direct the sound of music	movie_other
show me magazine reviews	other
language	other
what do the actors speak	other
auqua fish	other
bing star wars four	movie_other
camping	other
classic cars	other
he gets a job in a big city	other
he works in a toy company	other
healing plants	other
herbs and health	other
house at the street	other
house on mend street	other
house on over street	other
houses on streets	other
i wonder if time travel is possible	other
info zombies	other
list zombies	other
netflix	other
scary	other
select shown information	other
unique cars	other
water beast	other
zombies	other
zombies info	other
zombies list	other
rating	movie_other
why is rated g	movie_other
how old is miley cirus	other
show me pictures of beautiful people	other
albery death yr	other
arabic life of a movie	other
bald male actors	movie_other
brazil rates of pay	other
can i have a map of britain please	other
can i see a list of movie genres	movie_other
change rating because sometimes monsters scare kids	other
click on the orang information	other
countries flags	other
des ireland have any movie festivals	other
did hotel transylvania break any records	movie_other
did you enjoy voice acting for the movie kung fo panda	movie_other
did you have arguments with anyother set members	other
did you have conflits with anyone	other
did you have fun directing gilda mister vidor	movie_other
did you have fun directing your films	movie_other
did you help with anything other than the script	other
different country flags	other
display all the flags of the world	other
do they have oscar awards in india	movie_other
do you have dress in stock	other
england will you make movie about the life of prince william and harry 's life	movie_other
find map of canada	other
find select info	other
flags	other
flags of foreign countries	other
give me more information about the text highlighted in orange	other
goto greyscale	other
how ad would you be	other
how can a movie be nr	movie_other
how do movies receive r ratings	movie_other
how do people live in japan	other
how do they determine the rating levels for movies	movie_other
how many people live in japan	other
how old do you have to be to see an r rated movie	movie_other
how old do you need to be to watch r movies	movie_other
how popular do you think the movie will be	movie_other
i love alfred hitchcock	other
i need information about parental guidance ratings	movie_other
i want to see all the flags of the world	other
i would like to get details about the information in orange	other
if he was still making movies would you want to help	movie_other
if the movie was canceled how mad do you think the public would be	movie_other
if you could descrbe your movie in one word what would it be	movie_other
if you werent the director	movie_other
i 'm looking for a map of britain	other
images of foreign countries	other
in search of the map of canada	other
is punjabi a language	other
is tom cruise going to do another mission imposiible	movie_other
is wb owned by another company as of right now and they just keep their tag name	movie_other
jenn ann house	other
jenn ann news feed twenty ten	other
look for information about parental guidance	movie_other
mister lester did you get to meet the beatles	other
movie made	movie_other
movie parental guidance rating scale	movie_other
never would watch this movie with a rating of dredd change rating	movie_other
only show me movie ratings that my sixteen year old daughter can also view with me	movie_other
paramount - do you pay all the expenses for the stand byes	other
parental guidance scale	movie_other
pg information	movie_other
pull up the dropdown minue in orange	other
r info	movie_other
r rating means sex or nudity	movie_other
r rating means violence	movie_other
rating scale to rate guidance	movie_other
sb directort cuts	other
sb love life	other
search for parental guidance information	movie_other
should i let my kid see a pg thirteen movie alone	movie_other
show information in arabic	other
show information in english	other
show information in turkish	other
show me all the information highlighted in orange	other
show me flags of the world	other
show me information in orange	other
show me more details about the information highlighted in orange	other
show me movie production logos	movie_other
show me successfull people	other
show me the credits in orange	other
show me the movie history	movie_other
show me the not rated label	movie_other
show me the rated r movie label	movie_other
show me videos in orange	other
show me viewer ratings in orange	other
thirty dance	other
twenty one point two mill	other
twenty one point two was amazing	other
universal how many producers work to put a movie production together	other
was twenty one point two million grossed in the first day or week	other
what	other
what age group is an r movie appropriate for	movie_other
what age group is g rated movies for	movie_other
what are some different movie genres	movie_other
what are some flags of the world	other
what are the company logos you see at the beginning of a movie	movie_other
what are the names of some famous producers in hollywood	movie_other
what are the recommended ages for a pg thirteen movie	movie_other
what can an r rated movie show	movie_other
what does a g rating mean	movie_other
what does a movie have if it is rated r	movie_other
what does a pg rating mean	movie_other
what does a r rating mean	movie_other
what does nr stand for	movie_other
what does rated g mean	movie_other
what does rated r mean	movie_other
what does the flag of greece look like	other
what does the flag of japan look like	other
what does the flag of norway look like	other
what does the flag of vietnam look like	other
what does the paramount logo look like	movie_other
what is	other
what is the difference between an r rating and pg thirteen	movie_other
what is the difference between rated nr and r	movie_other
what is the g rating	movie_other
what is the main export of japan	other
what is the rating system called for movies	movie_other
what makes a movie get an r rating	movie_other
what types of movies are there	movie_other
where can i go to find additional rating information	movie_other
who was your favorite beatle	other
who was your favorite set member	movie_other
whos idea was it for kung fo panda two	other
why is the three d version and the standard version released on the same day	other
why is this movie rated pg	movie_other
why is this movie rated r	movie_other
would you try to make a sequal	other
show me ireland 's flag	other
searching for maps	other
where is japan	other
find	other
find all criteria	other
find all selected info	other
find highlighted info	other
funnie	other
genuine	other
grayscale	other
great	other
list page	other
noisy	other
search databases	other
search popularity	other
search selected info	other
september twenty eight	other
dirty dan	other
july	other
pg thirteen information	movie_other
adventeurous	other
find selected info	other
has he written anything new	other
love	other
wilford	other
william	other
pull up photos of sexy women	other
show me pictures of beautiful men	other
show me pictures of beautiful women	other
show me pictures of famous blondes	other
what does person look like	other
on julie	other
on july	other
send dredd movie	other
what does pg thirteen stand for	movie_other
would you make a sequel	other
show me the highlighted topics	other
want page	other
are the animated charactors protrayed as small or human size	other
what was the country where nobody knows takes place	other
show me bio of person	other
show me famous people	other
was the poularity good or bad	other
take me to freebase to find out more about this movie	movie_other
tyler p new projects	other
what movies have they done	movie_other
how many shaft movies are there	movie_count
how many movies has he directed this season	movie_count
how many movies has he directed	movie_count
did the dad in daddy daycare also play in dr doolittle	actor
who played the principal in ferris bueller 's day off	actor
show me the little girl from full house	actor
who is the gym teacher in glee	actor
who was richie 's mother in happy days	actor
who was barty crouch 's son in harry potter	actor
who was the sheriff that had to kill the bad guy in high noon	actor
who is the actress who played lucy 's best friend on i love lucy	actor
what actress played mother in mirror by tarkovsky	actor
who played the little girl in my girl	actor
who played opposite sidney poitier in shoot to kill	actor
who played the mother in steel magnolias	actor
who played the doctor in the doctor	actor
who is in picture five	actor
who is in picture one	actor
who is in picture two	actor
who are the actors	actor
find cast members	actor
the name of the actress who played the boy 's mother in the russian movie mirror	actor_name
what is the name of the red ranger guy in power rangers	actor_name
give me the name of the mom on seinfeld	actor_name
i need to know the name of the mom on seinfeld	actor_name
what is the name of the actor who played the dad in the parent trap	actor_name
get me the name of the actor what was the dad in to kill a mockingbird	actor_name
what awards did this film receive	award
did this movie win any awards	award
did this movie win any awards	award
has charles vidor won any awards	award
show richard lester 's awards	award_ceremony award_category
what awards has spielberg won	award_ceremony award_category
usa release date for the film little women	release_date
when will the sequel to the hunger games be released	release_date
release date	release_date
can you give me the release date	release_date
show me some of the greatest film directors of our time	director movie date star_rating
show me directors of famous films	director movie star_rating
show me famous directors	director movie star_rating
show me famous movie directors	director movie star_rating
show me the top hollywood film directors of all time	director movie star_rating
who are these directors	director
show me the director	director
name me the director	director_name
what genre	genre
what video clips have will ferrell	media
evil goes global video	media
display the video of finding nemo twenty oh three	media
get the video of finding nemo twenty oh three	media
watch finding nemo	media
watch movie omg oh nine twenty eight twenty twelve	media
omg video	media
show me videos of spielberg movies	movie media
what are the top five british dramas	movie star_rating
what is the worst french film to date	movie star_rating
what is the best french movie of all time	movie star_rating
what are the top ten french movies of all time	movie star_rating
what top movies are from the uk	movie star_rating
alfred hitchcock 's best films	movie star_rating
what is alfred hitchcock 's most famous movie	movie star_rating
show me martin scorcese 's best movies	movie star_rating
show me a popular robert wise movie	movie star_rating
what is the most popular steven spielberg movie	movie star_rating
what are the top rated movies this year	movie star_rating
show me the best films of twenty eleven for warner brothers	movie star_rating
tell me some of the best nc-17 movies	movie star_rating
adam sandler 's best movie list	movie star_rating
brad pitt popular movies	movie star_rating
give a list of best rated movies	movie star_rating
show me a set of movie trailers	movie trailer
show me movie trailers	movie trailer
preview paramount pictures clips	movie trailer
show me the movie highlights	movie trailer
display movies made in country	movie
locate movies made in country	movie
what has person directed	movie
what did lee unkridge direct	movie
cartoon with fish	movie
jennifer ann new releases	movie
what are some good american movies	movie
what is the top rated french comedy	movie
show me this years top rated italian movies	movie
what films has japan made this year	movie
spanish academy award winning movie	movie
what are the best british action movies	movie
show movies made in country	movie
find movies made in country	movie
tell me movies made in country	movie
movies by franco zephereli	movie
what is the latest movie directed by director two	movie
what movie is lee unkrich known for	movie
i need to know about some famous movies directed by martin scorsese	movie
i would like to know about some famous movies by director martin scorsese	movie
what movie is robert wise famous for directing	movie
show me the top ten movies of last year	movie
what new movies are coming up in france	movie
what upcoming movies are they producing	movie
give me a list of some famous movies in hindi language	movie
show me names of some famous movies in hindi language	movie
which movies filmed in asia won academy awards	movie
scary movies by this producer	movie
show me a list of movies made by the producer	movie
tell me movies produced by	movie
award movies for fox	movie
show me the films from paramount that won oscars	movie
can you tell me some famous movies by producer walt disney	movie
what are some good g rated movies	movie
jennifer lawrence new movie	movie
show brad pitt movies with angelina jolie as actress	movie
i would like to know the names of some award winning movies by indian actor dilip kumar	movie
show me kristen stewart 's worst movies	movie
show brad pitt movies nominated for oscars	movie
what are some great movies about sports heroes	movie
movies gross revenue of seven point two million dollars	movie
list movies released in italy in 2012	movie
upcoming movie releases in japan	movie
show me the movies released in london	movie
what movies are playing in mexico	movie
show me the movies released in srilanka	movie
what movies in the usa came out in 2012	movie
show me the movies released in america	movie
show me movies with a four star rating	movie
top movies	movie
what media has lionsgate done	movie
find shows about cars	movie
is this movie violent	movie
did life is beautiful win an academy award	movie
show all movies by oscar winning directors for the seventies	movie
did clint eastwood win an oscar for any of the movies he has directed	movie
what movies did meryl streep win her oscars	movie
find pictures of kristen stewart	picture
images for steven spielberg	picture
see images of steven spielberg	picture
show me images of steven spielberg	picture
what does stephen spielberg look like	picture
images of will ferrell	picture
all images of will ferrell	picture
display images of actor will ferrell in the news	picture
search for images of will ferrell	picture
show me images of will ferrell	picture
show me some pictures of will ferrell	picture
show me pictures of movie producers	producer picture
who are the most famous producers in hollywood	producer
who produced the motion picture the devil wears prada	producer
who produced the theatrical film the devil wears prada	producer
who produced	producer
who 's the producer	producer
find rating information about the movie dredd	rating star_rating
what is it rated	rating
what are the ratings for movies	rating
get finding nemo info and reviews	review movie
parental review for movie	review rating
critic reviews of dirty dancing	review
reviews for dirty dancing	review
reviews of dirty dancing	review
what were the reviews for dirty dancing	review
how have critics rated finding nemo	review
show me the reviews for finding nemo	review
what are the reviews for finding nemo	review
review for movie	review
reviews of movie	review
what are the reviews for movie	review
reviews for house at the end of the street	review
reviews of house at the end of the street	review
what are the reviews for house at the end of the street	review
reviews for in july	review
reviews for in july	review
reviews for in july	review
show me the reviews for in july	review
what are the reviews for in july	review
find reviews for life is beautiful	review
reviews for life is beautiful	review
reviews for life is beautiful	review
what are the reviews for life is beautiful	review
reviews for star wars four	review
reviews of star wars four	review
reviews of star wars four	review
reviews for star wars iv	review
reviews for the movie the campaign	review
show me the reviews on the movie the campaign	review
show me reviews for the movies in orange	review
show me the viewer ratings	review
show me viewer ratings	review
is star wars four any good	star_rating
how many stars does star wars new hope have	star_rating
give me the rating	star_rating
i want a synopsis for the movie in july	synopsis
what is the synopsis for the movie vulgaria	synopsis
where can i watch finding nemo	theater
where is movie playing	theater
where is movie playing	theater
which theatre is this playing in	theater
where is hotel transylvania shown	theater
where can i see house at the end of the street	theater
where is house at the end of the street playing	theater
where is the movie in july playing	theater
where is the movie campaign playing	theater
where can i see the campaign	theater
where is the campaign playing	theater
show me trailers for finding nemo	trailer
find me trailers for house at the end of the street	trailer
show trailer of house at the end of the street	trailer
watch trailer for star wars iv	trailer
show me the trailer for the campaign movie	trailer
find trailer for the campaign	trailer
play the trailer for the campaign	trailer
show trailer for the campaign	trailer
how many awards did alfred hitchcock win for directing	award_count
how many oscars has meryl streep won	award_category_count
how many of the star wars movies won awards	movie_count
play english movie	media
were there any movies that came out this year filmed in france	movie
what are some popular japanese movies	movie
