!	!
'	'
'd	will
'll	will
'm	be
're	be
's	's
's	be
't	't
-	-
1	1
1000	@card@
13	@card@
13th	13th
16	@card@
17	@card@
1990	@card@
1995	@card@
1998	@card@
1st	1st
2	2
20	@card@
2000	@card@
2009	@card@
2010	@card@
2012	@card@
21	@card@
24	@card@
3	3
3d	3d
4	4
7	7
70s	70s
9	9
9-11	@card@
:	:
I	I
a	a
aankhen	aankhen
abbey	abbey
about	about
above	above
abrams	abrams
abramson	abramson
academy	academy
accumalate	accumalate
act	act
acted	act
acting	act
action	action
activity	activity
actor	actor
actors	actor
actress	actress
acts	act
ad	ad
adam	adam
additional	additional
adult	adult
adults	adult
adventeurous	adventeurous
africa	Africa
africa	africa
african	African
after	after
age	age
aged	age
ages	age
aguirre	aguirre
akrend	akrend
alan	alan
albert	albert
alberts	albert
albery	albery
album	album
albums	album
alfred	Alfred
alfred	alfred
alive	alive
all	all
allen	allen
alone	alone
also	also
am	be
amazing	amazing
amelie	amelie
america	america
american	American
amityville	amityville
amount	amount
an	an
anchorman	anchorman
and	and
anderson	anderson
andrew	andrew
angelina	Angelina
angelina	angelina
angels	angel
animated	animated
anime	anime
aniston	aniston
ann	Ann
anna	anna
annamayya	annamayya
anne	anne
annette	annette
another	another
antogonist	antogonist
ants	ant
antwon	antwon
any	any
anymore	anymore
anyone	anyone
anyother	anyother
anything	anything
apartheid	apartheid
apocolypse	apocolypse
apollo	apollo
appear	appear
appeared	appear
appolo	appolo
appropriate	appropriate
arabic	Arabic
are	be
arguments	argument
armstrong	armstrong
around	around
art	art
arts	art
as	as
asia	Asia
asia	asia
at	at
audience	audience
aug	Aug
auqua	auqua
available	available
avatar	avatar
avenger	avenger
avengers	avenger
avergers	avergers
award	award
awards	award
away	away
b	b
back	back
background	background
bacon	bacon
bad	bad
bala	bala
bald	bald
bale	bale
bananas	banana
bank	bank
barbra	barbra
barfi	barfi
barry	Barry
barrymore	barrymore
barty	barty
baseball	baseball
based	base
basketball	basketball
bastardos	bastardos
batman	batman
baumbach	Baumbach
bay	bay
be	be
beaches	beach
beast	beast
beatiful	beatiful
beatle	beatle
beatles	beatles
beautfiul	beautfiul
beautiful	beautiful
beauty	beauty
beaver	beaver
because	because
become	become
been	be
before	before
beginning	beginning
begins	begin
behind	behind
believe	believe
belle	belle
belongs	belong
bengali	bengali
benigni	Benigni
berry	berry
best	good
best	well
bette	bette
between	between
big	big
bill	bill
bing	bing
bings	bings
bio	bio
biographies	biography
biography	biography
birds	bird
birthday	birthday
black	black
blanca	blanca
bleibtreu	bleibtreu
blind	blind
blondes	blonde
blood	blood
boots	boot
born	bear
bourne	bourne
box	box
box-office	box-office
boy	boy
boys	boy
brad	brad
brazil	brazil
break	break
breaking	break
brian	Brian
brian	brian
bride	bride
bring	bring
britain	britain
britian	britian
british	British
brittney	brittney
brooke	brooke
brooks	brook
bros	bros
bros.	bros.
brothers	brother
brown	brown
browse	browse
bruce	bruce
bruckheimer	bruckheimer
budbrigeren	budbrigeren
budget	budget
budgeted	budget
bueller	bueller
buget	buget
bullhead	bullhead
bullock	bullock
bundle	bundle
burton	burton
businessman	businessman
busters	buster
buy	buy
by	by
byes	bye
cabin	cabin
caddy	caddy
calendar	calendar
called	call
came	come
cameron	cameron
camp	camp
campaign	campaign
camping	camping
can	can
canada	canada
canadian	Canadian
canceled	cancel
cannot	can
capra	capra
captain	captain
car	car
care	care
career	career
caribean	caribean
carpet	carpet
cars	car
cartoon	cartoon
casa	casa
casino	casino
cast	cast
castle	castle
castmembers	castmembers
category	category
catergory	catergory
cecil	cecil
cell	cell
century	century
chan	chan
change	change
character	character
characters	character
charactors	charactors
charles	charles
charlie	charlie
chaser	chaser
chases	chase
cheap	cheap
check	check
cher	cher
chess	chess
chewbakka	chewbakka
chick	chick
child	child
children	child
childrens	childrens
childs	childs
china	china
chinese	Chinese
chips	chip
chiranjeevi	chiranjeevi
chloe	Chloe
chopra	Chopra
chopra	chopra
choudary	choudary
chris	chris
chrisian	chrisian
christ	christ
christian	Christian
christmas	christmas
church	church
cirus	cirus
citizen	citizen
city	city
clark	clark
classic	classic
classics	classic
classification	classification
classified	classify
clause	clause
click	click
clint	clint
clips	clip
clive	clive
clooney	clooney
clueless	clueless
co-star	co-star
columbia	columbia
columbus	Columbus
come	come
comedians	comedian
comedies	comedy
comedy	comedy
comes	come
coming	come
companies	company
company	company
compile	compile
complete	complete
compliance	compliance
composer	composer
computers	computer
concerning	concern
conflits	conflits
congeniality	congeniality
connery	connery
considered	consider
content	content
copolla	copolla
cortlund	cortlund
cost	cost
costars	costar
costner	costner
costs	cost
could	could
countries	country
country	country
courageous	courageous
crank	crank
created	create
credits	credit
crew	crew
crimes	crime
criteria	criterion
critic	critic
critics	critic
crouch	crouch
crowe	Crowe
cruise	cruise
cujo	cujo
cukor	cukor
culture	culture
current	current
currently	currently
curve	curve
cusack	cusack
cuts	cut
czech	Czech
d	d
d-war	d-war
dad	dad
daddy	daddy
damon	damon
dan	dan
dance	dance
dancing	dancing
danish	Danish
dark	dark
darla	darla
darth	darth
data	datum
databases	database
date	date
dates	date
dating	date
daughter	daughter
dawn	dawn
dax	dax
day	day
daycare	daycare
days	day
de	de
dead	dead
deal	deal
death	death
debaters	debater
debut	debut
decade	decade
deer	deer
degeneres	degeneres
demille	demille
deniro	deniro
denzel	denzel
depp	depp
des	des
descrbe	descrbe
describe	describe
despicable	despicable
detail	detail
detailed	detailed
details	detail
detective	detective
determine	determine
devil	devil
dialect	dialect
diane	Diane
diaz	diaz
dick	dick
did	do
die	die
difference	difference
different	different
diggs	diggs
dilip	dilip
direct	direct
directed	direct
directed	directed
directing	direct
directing	directing
director	director
directors	director
directort	directort
directs	direct
dirty	dirty
discover	discover
discuss	discuss
disney	Disney
disney	disney
dispaly	dispaly
display	display
diving	diving
divorce	divorce
dna	dna
do	do
doctor	doctor
documentaries	documentary
documentary	documentary
does	do
dogs	dog
dollars	dollar
dollhouse	dollhouse
don	don
done	do
doolittle	doolittle
dory	dory
download	download
downton	downton
dr	Dr
dragon	dragon
dragons	dragon
drama	drama
dramas	drama
dramas	dramas
dreams	dream
dreamworks	dreamworks
dredd	dredd
dress	dress
drew	draw
driver	driver
dropdown	dropdown
duff	duff
during	during
dutch	dutch
e	e
e.t.	e.t.
earn	earn
earnings	earning
eastwood	eastwood
eating	eating
ed	edited
ed	editor
eddie	eddie
eight	eight
eighties	eighty
eighty	eighty
el	el
eleven	eleven
elizabeth	Elizabeth
elizabeth	elizabeth
ellen	ellen
elling	elling
elm	elm
else	else
elvis	elvis
emma	emma
en	en
end	end
england	england
english	English
enjoy	enjoy
enterainment	enterainment
entertainment	entertainment
entitled	entitle
epic	epic
episode	episode
esme	esme
esp	esp
et	et
etc	etc
ethel	ethel
europe	europe
eva	eva
ever	ever
every	every
evil	evil
exhibit	exhibit
exorcist	exorcist
expect	expect
expecting	expect
expendables	expendable
expenses	expense
expensive	expensive
experience	experience
export	export
facing	face
facts	fact
falls	fall
family	family
famous	famous
fantasy	fantasy
farrell	farrell
fast	fast
fat	fat
father	father
favorite	favorite
favorites	favorite
feature	feature
feed	fee
fellows	fellow
female	female
ferell	Ferell
ferrel	ferrel
ferrell	Ferrell
ferrell	ferrell
ferris	ferris
festivals	festival
fi	fi
fiction	fiction
field	field
fifties	fifty
figure	figure
figures	figure
film	film
filmed	film
filmography	filmography
films	film
find	find
finding	find
finding	finding
first	first
fish	fish
fisher	fisher
five	five
flag	flag
flags	flag
fleming	fleming
flicks	flick
floats	float
flowers	flower
flys	flys
fo	fo
footloose	footloose
footnote	footnote
for	for
forager	forager
ford	ford
foreign	foreign
forest	forest
forever	forever
forrest	forrest
forty	forty
four	four
fourteen	fourteen
fox	fox
france	france
frances	frances
franco	franco
frank	frank
frankenstein	frankenstein
free	free
freebase	freebase
freedom	freedom
freeman	freeman
french	French
french	french
friday	friday
friend	friend
friendly	friendly
from	from
full	full
fun	fun
funnie	funnie
funny	funny
furious	furious
fury	fury
future	future
g	g
g-rated	g-rated
gable	gable
gables	gable
gabrielle	gabrielle
gambling	gambling
game	game
games	game
garayh	garayh
garden	garden
gardening	garden
gardening	gardening
gardens	garden
gatsby	gatsby
general	general
generate	generate
generated	generate
genre	genre
genres	genre
genuine	genuine
george	george
georges	georges
german	german
germany	germany
get	get
gets	get
getting	get
ghost	ghost
ghostbusters	ghostbuster
giants	giant
gibson	gibson
gilda	Gilda
gilda	gilda
girl	girl
girls	girl
give	give
glazer	glazer
glee	glee
global	global
go	go
god	god
godfather	godfather
godzilla	godzilla
goes	go
going	go
gomez	gomez
gone	go
good	good
goodfellas	goodfellas
goto	Goto
goto	goto
government	government
grayscale	grayscale
grease	grease
great	great
greatest	great
greece	greece
greek	Greek
green	green
greenberg	Greenberg
grey	grey
greyscale	greyscale
grizzly	grizzly
gross	gross
grossed	gross
grossing	gross
group	group
guidance	guidance
guido	guido
gump	gump
gun	gun
guy	guy
guys	guy
gyllenhaal	gyllenhaal
gym	gym
had	have
hair	hair
halle	halle
halloween	halloween
hamlet	hamlet
han	han
hangover	hangover
hanks	hank
happiness	happiness
happy	happy
hard	hard
harris	harris
harrison	harrison
harry	harry
has	have
hathaway	hathaway
haunting	haunting
have	have
having	have
havre	havre
he	he
healing	healing
health	health
healthy	healthy
help	help
her	her
herbs	herb
herione	herione
hero	hero
heroes	hero
heroine	heroine
high	high
highest	high
highest-grossing	highest-grossing
highlighted	highlight
highlights	highlight
hillary	hillary
hindi	Hindi
hindi	hindi
hired	hire
his	his
historical	historical
history	history
hitch	hitch
hitchcock	Hitchcock
hitchcock	hitchcock
hitting	hit
hobbist	hobbist
hobbit	hobbit
hobby	hobby
hold	hold
hollywood	hollywood
holmes	Holmes
holocaust	holocaust
home	home
homepage	homepage
homer	homer
honey	honey
hope	hope
hornet	hornet
horror	horror
horses	horse
hotel	hotel
house	house
houses	house
how	how
howard	howard
hugh	hugh
hulk	hulk
hum	hum
human	human
hungarian	Hungarian
hungary	hungary
hunger	hunger
hunter	hunter
huntsman	huntsman
i	i
ice	ice
idea	idea
identity	identity
if	if
images	image
immigrants	immigrant
immigration	immigration
impossible	impossible
in	in
inc	Inc
inception	inception
incredibles	incredibles
india	india
indian	Indian
indiana	indiana
indochine	indochine
info	info
infomation	infomation
informaion	informaion
information	information
interested	interested
into	into
involve	involve
involves	involve
involving	involve
ireland	Ireland
ireland	ireland
irish	Irish
iron	iron
is	be
issues	issue
it	it
italian	Italian
italy	italy
itself	itself
iv	iv
jack	jack
jackie	jackie
jackman	jackman
jake	jake
james	james
japan	japan
japaneese	japaneese
japanese	Japanese
jason	Jason
jason	jason
jaws	jaw
jaws	jaws
jedi	jedi
jenn	Jenn
jennifer	Jennifer
jennifer	jennifer
jerry	jerry
jj	jj
job	job
johar	Johar
johar	johar
john	john
johnny	johnny
jolie	Jolie
jolie	jolie
jon	jon
jones	jones
ju	ju
julia	julia
julian	Julian
julie	julie
july	July
july	july
jurassic	Jurassic
just	just
k	k
kahani	kahani
kane	kane
kannada	kannada
karan	Karan
karan	karan
karate	karate
kareena	kareena
karinia	karinia
kati	kati
katie	Katie
keaton	Keaton
keep	keep
kelly	kelly
kevin	kevin
kid	kid
kids	kid
kill	kill
kind	kind
kindly	kindly
king	king
kingdom	kingdom
kinky	kinky
knight	knight
know	know
known	know
knows	know
korean	Korean
krishna	krishna
kristen	Kristen
kristen	kristen
kristenn	kristenn
kumar	kumar
kung	kung
kyra	kyra
la	la
label	label
ladies	lady
lambs	lamb
land	land
landau	landau
language	language
languages	language
lassiter	lassiter
last	last
lately	lately
latest	late
laurie	laurie
law	law
lawless	lawless
lawn	lawn
lawrence	lawrence
le	le
lead	lead
learn	learn
least	least
leave	leave
lee	lee
left	leave
legal	legal
legend	legend
length	length
leone	leone
les	les
lester	lester
let	let
levels	level
libraries	library
lies	lie
lieutenant	lieutenant
life	life
like	like
lion	lion
liongate	liongate
lionsgate	lionsgate
list	list
listed	list
listing	list
listing	listing
little	little
live	live
locate	locate
located	locate
logo	logo
logos	logo
london	london
long	long
look	look
looking	look
looper	looper
lord	lord
lost	lose
lot	lot
love	love
lucas	lucas
lucus	lucus
lucy	lucy
luke	luke
lumit	lumit
macdonald	macdonald
mad	mad
madagascar	madagascar
made	make
magazine	magazine
magic	magic
magnolias	magnolia
maid	maid
main	main
make	make
makes	make
making	make
making	making
malayalam	malayalam
male	male
man	man
mandarin	mandarin
many	many
map	map
maps	map
margin	margin
mario	mario
marley	marley
married	marry
martin	martin
mask	mask
master	master
matt	matt
may	may
mcgovern	mcgovern
me	me
mean	mean
means	mean
mechanic	mechanic
media	medium
meet	meet
meg	meg
mel	mel
member	member
members	member
men	man
mend	mend
mendes	mendes
mermaid	mermaid
meryl	meryl
mes	mes
mexican	Mexican
mexico	mexico
mgm	mgm
michael	Michael
michael	michael
michelle	Michelle
middle	middle
midler	midler
mil	mil
miley	miley
mill	mill
million	million
millionaire	millionaire
minue	minue
minutes	minute
miramax	miramax
mirror	mirror
miserable	miserable
miserables	miserables
mission	mission
mister	mister
moby	moby
mockingbird	mockingbird
modern	modern
moives	moives
mom	mom
money	money
monster	monster
monsters	monster
month	month
mood	mood
moon	moon
more	more
morgan	morgan
moritz	Moritz
moscow	moscow
mosfilm	mosfilm
most	most
mother	mother
motion	motion
moustache	moustache
movie	movie
movies	movie
moview	moview
mpaa	mpaa
mr	Mr
mrs	Mrs
ms.	ms.
much	much
murphey	murphey
murphy	murphy
music	music
musical	musical
musicals	musical
must	must
muvva	muvva
my	my
mystery	mystery
name	name
names	name
namitha	namitha
nature	nature
nc	nc
nc-17	nc-17
need	need
nemo	Nemo
nemo	nemo
netflix	netflix
network	network
never	never
new	new
newest	new
news	news
next	next
nick	nick
niel	niel
night	night
nightmare	nightmare
nightmares	nightmare
nine	nine
nineteen	nineteen
ninety	ninety
noah	Noah
nobody	nobody
noisy	noisy
nolan	nolan
nominated	nominate
noon	noon
norway	norway
norwegian	Norwegian
not	not
now	now
nr	nr
nudity	nudity
number	number
numbers	number
october	October
of	of
off	off
office	office
official	official
often	often
oh	oh
ok	ok
old	old
older	old
oldest	old
oliver	olive
olsen	olsen
omg	omg
on	on
ondskan	ondskan
one	one
online	online
only	only
open	open
opening	opening
opposite	opposite
option	option
options	option
or	or
orang	orang
orange	orange
oranges	orange
origin	origin
original	original
originally	originally
oscar	oscar
oscars	oscar
other	other
our	our
out	out
outside	outside
over	over
overall	overall
overboard	overboard
overview	overview
owen	owen
owned	own
oz	Oz
p	p
packer	packer
page	page
palma	Palma
panda	panda
paquin	paquin
parador	parador
paraiso	paraiso
paramount	paramount
paranormal	paranormal
paranorman	paranorman
parent	parent
parental	parental
parenthood	parenthood
paris	paris
park	park
part	part
particulars	particular
passion	passion
patang	patang
patrick	patrick
patriot	patriot
pattinson	pattinson
paul	paul
paxton	paxton
pay	pay
pelham	pelham
penn	penn
people	people
perfect	perfect
period	period
perry	perry
person	person
pfiefer	pfiefer
pg	pg
pg-13	pg-13
phifer	phifer
photos	photo
pi	pi
picture	picture
pictures	picture
pie	pie
pirates	pirate
pitch	pitch
pitchperfect	pitchperfect
pitt	pitt
pixar	pixar
place	place
plants	plant
platoon	platoon
play	play
played	play
playing	play
playing	playing
plays	play
please	please
plot	plot
plots	plot
point	point
pointier	pointier
poitier	poitier
poland	poland
polish	polish
polley	polley
popular	popular
popularity	popularity
portugese	portugese
portuguese	Portuguese
possed	poss
posseion	posseion
possesion	possesion
possessed	possess
possession	possession
possible	possible
potter	potter
poularity	poularity
power	power
prada	prada
prejudice	prejudice
preschool	preschool
president	president
pretty	pretty
preview	preview
prices	price
pride	pride
prince	prince
princess	princess
principal	principal
prison	prison
procuced	procuced
produce	produce
produced	produce
producer	producer
producers	producer
produces	produce
producing	produce
production	production
productions	production
professional	professional
profile	profile
profiles	profile
profit	profit
profits	profit
projects	project
protrayed	protrayed
provide	provide
public	public
pull	pull
pulp	pulp
punjabi	punjabi
punjaki	punjaki
puss	puss
put	put
pyaar	pyaar
quentin	quentin
quotes	quote
r	r
r-rated	R-rated
rabbit	rabbit
race	race
raiders	raider
rambo	rambo
ranam	ranam
ranger	ranger
rangers	ranger
rate	rate
rated	rate
rates	rate
rating	rate
rating	rating
ratings	rating
ray	ray
realase	realase
realease	realease
realese	realese
really	really
reba	reba
rebel	rebel
reccommended	reccommended
receipts	receipt
receive	receive
recent	recent
recently	recently
recommended	recommended
records	record
red	red
redford	Redford
redford	redford
regarding	regard
reiner	Reiner
relase	relase
relased	relased
related	relate
related	related
release	release
released	release
releases	release
relesed	relesed
relevant	relevant
reliance	reliance
religious	religious
remember	remember
rent	rent
reported	report
republic	republic
request	request
resident	resident
responsible	responsible
restless	restless
restrictions	restriction
results	result
retribution	retribution
return	return
returned	return
returns	return
revanche	revanche
revenue	revenue
revenues	revenue
review	review
reviews	review
revinue	revinue
revolution	revolution
richard	richard
richie	Richie
rickman	rickman
rider	rider
ridley	Ridley
right	right
rings	ring
rises	rise
rising	rise
rob	rob
robberies	robbery
robert	Robert
robert	robert
roberto	Roberto
roberts	roberts
robin	robin
rock	rock
rocky	rocky
roger	roger
role	role
roll	roll
romance	romance
romantic	romantic
romeo	romeo
ron	ron
royale	royale
ruddy	ruddy
rudy	rudy
run	run
russell	Russell
russia	russia
russian	Russian
rwanda	rwanda
ryan	ryan
s	s
safe	safe
sales	sale
sally	sally
sam	sam
same	same
sandler	sandler
sandlot	sandlot
sandra	sandra
santa	santa
sarah	sarah
satyricon	satyricon
savages	savage
sb	sb
scale	scale
scare	scare
scary	scary
scenes	scene
scheduled	schedule
school	school
sci	sci
scifi	scifi
scooby	scooby
scorcese	scorcese
score	score
scorscese	scorscese
scorsese	scorsese
scotland	scotland
scott	Scott
scott	scott
script	script
sean	sean
search	search
searching	search
searchlight	searchlight
season	season
seattle	Seattle
second	second
secretariat	secretariat
secrets	secret
see	see
seinfeld	seinfeld
select	select
selected	select
selected	selected
selena	selena
send	send
separation	separation
seperation	seperation
sept	sept
september	September
sequal	sequal
sequel	sequel
sergio	sergio
set	set
seven	seven
seventeen	seventeen
seventies	seventy
seventieseven	seventieseven
seventy	seventy
several	several
sevigny	Sevigny
sex	sex
sexy	sexy
shack	shack
shaft	shaft
shark	shark
she	she
sheen	sheen
shelly	shelly
shepard	shepard
sheriff	sheriff
shindler	Shindler
shindler	shindler
shoot	shoot
short	short
shortcut	shortcut
shot	shoot
should	should
show	show
showcase	showcase
showing	show
showing	showing
shown	show
shows	show
shrek	shrek
siddly	siddly
side	side
sidney	sidney
signs	sign
silence	silence
similar	similar
simpson	simpson
simpsons	simpsons
since	since
singer	singer
singleton	singleton
sings	sing
sinister	sinister
sirisiri	sirisiri
site	site
six	six
sixteen	sixteen
sixties	sixty
size	size
skating	skate
skating	skating
skywalker	skywalker
sleeping	sleep
sleepless	sleepless
slumdog	slumdog
small	small
smith	smith
smurfs	Smurf
snow	snow
social	social
solo	solo
solondz	solondz
some	some
something	something
sometimes	sometimes
son	son
sone	sone
sonnenfeld	Sonnenfeld
soon	soon
sorcerer	sorcerer
sort	sort
soul	soul
sound	sound
south	south
space	space
spaceballs	Spaceball
spain	spain
spanglish	spanglish
spanish	Spanish
sparkle	sparkle
speak	speak
speaking	speak
speaking	speaking
specific	specific
speilberg	speilberg
spend	spend
spending	spending
spent	spend
spider	spider
spiderman	spiderman
spielberg	Spielberg
spielberg	spielberg
spike	spike
spilberg	spilberg
spirit	spirit
spoken	speak
sports	sport
srilanka	srilanka
stand	stand
standard	standard
stanton	stanton
star	star
stared	stare
stark	stark
starred	star
starring	star
stars	star
start	start
starting	start
starwars	starwars
states	state
statham	statham
stathon	stathon
stats	stat
steel	steel
step	step
stephanie	stephanie
stephen	Stephen
stephen	stephen
steven	Steven
steven	steven
stewart	Stewart
stewart	stewart
still	still
stock	stock
stone	stone
stories	storey
storm	storm
story	story
stoy	stoy
streep	streep
street	street
streets	street
streisand	streisand
studio	studio
studios	studio
stuff	stuff
sub-titles	sub-titles
successfull	successfull
sudow	sudow
suggestions	suggestion
suitable	suitable
summary	summary
superman	superman
surfer	surfer
suspenseful	suspenseful
swan	swan
swayze	swayze
sweden	Sweden
swedish	Swedish
sy	sy
synopsis	synopsis
system	system
t	t
tag	tag
take	take
takes	take
taking	take
tales	tale
talk	talk
tamil	Tamil
tarkovsky	tarkovsky
tarrantino	tarrantino
taxi	taxi
taye	taye
teacher	teacher
tears	tear
ted	ted
teddy	teddy
television	television
tell	tell
ten	ten
terminator	terminator
terrantino	terrantino
terry	terry
text	text
th	th
than	than
that	that
the	the
theaters	theater
theatre	theatre
theatres	theatre
theatrical	theatrical
their	their
them	them
themed	them
themes	theme
there	there
these	these
they	they
thing	thing
think	think
thirteen	thirteen
thirty	thirty
this	this
thoda	thoda
thor	thor
thousand	thousand
three	three
thriller	thriller
thrillers	thriller
thunder	thunder
ticket	ticket
tidbits	tidbit
tim	tim
time	time
tin	tin
tips	tip
titanic	titanic
title	title
titles	title
to	to
today	today
todd	todd
together	together
tom	tom
tommyknockers	Tommyknocker
tongue	tongue
tonight	tonight
tony	tony
top	top
topic	topic
topics	topic
total	total
toy	toy
trailer	trailer
trailers	trailer
trainspotting	trainspotting
transformers	transformer
translated	translate
translyvania	translyvania
transylavania	transylavania
transylvania	transylvania
trap	trap
travel	travel
travolta	travolta
trivikram	trivikram
trouble	trouble
troy	troy
try	try
trying	try
tum	tum
turkey	turkey
turkish	Turkish
turn	turn
tv	tv
twelve	twelve
twentieth	twentieth
twenty	twenty
twilight	twilight
twins	twin
two	two
tyler	tyler
type	type
types	type
ugly	ugly
uk	uk
union	union
unique	unique
united	unite
united	united
universal	universal
unkrich	unkrich
unkridge	unkridge
unsolved	unsolved
up	up
upcoming	upcoming
us	us
usa	usa
used	use
vader	vader
vampires	vampire
varsham	varsham
vengeance	vengeance
version	version
versions	version
victor	victor
video	video
videos	video
vidor	vidor
vietnam	Vietnam
view	view
viewer	viewer
viewers	viewer
violence	violence
violent	violent
vivian	vivian
voice	voice
voices	voice
von	von
vow	vow
vulgaria	vulgaria
wall-e	wall-e
walt	Walt
walt	walt
want	want
war	war
warner	warner
wars	war
was	be
washington	washington
watch	watch
watching	watch
water	water
watson	watson
way	way
wb	wb
we	we
wears	wear
wedding	wedding
wednesday	Wednesday
week	week
weekend	weekend
weinstein	weinstein
welcome	welcome
were	be
werent	werent
wes	wes
westerns	western
what	what
whats	whats
when	when
where	where
which	which
while	while
white	white
who	who
whom	whom
whos	whos
whose	whose
why	why
wife	wife
wildflowers	wildflower
wilford	Wilford
will	will
william	William
william	william
willis	willis
win	win
wind	wind
winning	win
wise	wise
with	with
wizard	wizard
wolf	wolf
woman	woman
women	woman
won	win
wonder	wonder
wood	wood
woods	wood
woody	woody
word	word
words	word
work	work
worked	work
works	work
world	world
worldwide	worldwide
worst	bad
would	would
wrath	wrath
writers	writer
written	write
wrong	wrong
wrote	write
yash	yash
year	year
years	year
yet	yet
you	you
young	young
your	your
yr	Yr
zealand	zealand
zephereli	zephereli
zombie	zombie
zombies	zombie
zucker	zucker
